CGTCCGGGACAAGAGAAGC: GTCCGGGACAAGAGAAGCG
CAAACTCAACCTGCGGAGC: AAACTCAACCTGCGGAGCT
TTTAAGGCGGTTATGAGAT: TTAAGGCGGTTATGAGATC
TCACCTCAACGTCCTCTAA: CACCTCAACGTCCTCTAAA
ACGCGAGCTAAGATTTGAT: CGCGAGCTAAGATTTGATC
CCGAATCCCTAAAAAGCAC: CGAATCCCTAAAAAGCACG
CACCTGGCCCACAGGTATC: ACCTGGCCCACAGGTATCG
TTTCCCTTGATCATGCGTG: TTCCCTTGATCATGCGTGC
ATTTAGATAGCTCCCACCT: TTTAGATAGCTCCCACCTC
AGGATTTGAGCATTATTGG: GGATTTGAGCATTATTGGT
GTATTCAAGCGGATGTCGA: TATTCAAGCGGATGTCGAC
TAATACGCAGAAGGAGAAC: AATACGCAGAAGGAGAACA
GGGTCATTTACGAAGCAAT: GGTCATTTACGAAGCAATC
AGTAGTGGCTCAAGCCGAG: GTAGTGGCTCAAGCCGAGC
ATAACGGGCTGTCGCCCTT: TAACGGGCTGTCGCCCTTG
CCGTATTCAAGCCGAATCC: CGTATTCAAGCCGAATCCC
GTGGCATGCATGGCGGGCT: TGGCATGCATGGCGGGCTT
GTTAAATCTAGCAGCACAC: TTAAATCTAGCAGCACACT
TGGAGGATGATGTCTACTA: GGAGGATGATGTCTACTAC
CTACTACCGCCAACCTGCC: TACTACCGCCAACCTGCCG
AATGTGCCTACTGCGCGAT: ATGTGCCTACTGCGCGATT
TCTAAAGAGCACAACAACT: CTAAAGAGCACAACAACTG
ATCCGGTAGGCAGTCCCTT: TCCGGTAGGCAGTCCCTTG
CAACGCATGGACTGATCTG: AACGCATGGACTGATCTGT
CAAACTGTCCCCATTAAGC: AAACTGTCCCCATTAAGCA
GGAGCTCAAGGTTCCGGGC: GAGCTCAAGGTTCCGGGCG
CAGTTCGTCTGGCGTATCT: AGTTCGTCTGGCGTATCTC
AGGCCGTTCTTACGGACCA: GGCCGTTCTTACGGACCAT
CCCCTAGCAACGAATTTAG: CCCTAGCAACGAATTTAGC
CAAAATAACGGGCTGTCGC: AAAATAACGGGCTGTCGCC
GGTTATGAGATCACAAACT: GTTATGAGATCACAAACTG
TTTCCTGTGGGTACACGGG: TTCCTGTGGGTACACGGGG
CTTGGAACACAATTCTGCC: TTGGAACACAATTCTGCCC
TCTGTGGAACTAATATGTC: CTGTGGAACTAATATGTCG
GAGAAGCGGAGCCATGGAT: AGAAGCGGAGCCATGGATT
TACAGGGTTTTGTTCTCTG: ACAGGGTTTTGTTCTCTGG
ATTTCAGCTCACTTACATA: TTTCAGCTCACTTACATAC
GAACTAATATGTCGTCCAC: AACTAATATGTCGTCCACC
CTTTATATGCCTGCGGATT: TTTATATGCCTGCGGATTC
AGTATACTTTGACCATCAG: GTATACTTTGACCATCAGC
CTCAATGTGCCTACTGCGC: TCAATGTGCCTACTGCGCG
AATTTCTTTGAAGTACAGT: ATTTCTTTGAAGTACAGTG
TAGATAGCTCCCACCTCCC: AGATAGCTCCCACCTCCCA
TAGGCATATGCCCGGGCGT: AGGCATATGCCCGGGCGTG
TGCCAAGTGGAAAAGCACG: GCCAAGTGGAAAAGCACGG
CTGTCGCCCTTGCAACTTG: TGTCGCCCTTGCAACTTGT
TCCCTTGATCATGCGTGCC: CCCTTGATCATGCGTGCCA
TTGGTAATACCAGTTCTAA: TGGTAATACCAGTTCTAAG
CCGTATTCAAGCAACTACT: CGTATTCAAGCAACTACTG
CTGGCTCTTTGAATGAGAG: TGGCTCTTTGAATGAGAGT
GCACGGAGTAAGTAGTGGC: CACGGAGTAAGTAGTGGCT
GGAGCTTACCTAGAGCTCG: GAGCTTACCTAGAGCTCGT
AACTGTCCCCATTAAGCAC: ACTGTCCCCATTAAGCACC
CTGAGGGACTCGCTTAACA: TGAGGGACTCGCTTAACAG
CGCTACAAGTTAATCGCCG: GCTACAAGTTAATCGCCGG
ATAGAGCGATGTGATAACT: TAGAGCGATGTGATAACTA
CATAATCTTTTACGCACTC: ATAATCTTTTACGCACTCC
GGCGTGAGAGCCCGTCAAC: GCGTGAGAGCCCGTCAACT
CTGAGAAAGAACCGAATCC: TGAGAAAGAACCGAATCCC
ATATGTCGTCCACCTCCTA: TATGTCGTCCACCTCCTAC
GCAAATTAAAACACTGGTA: CAAATTAAAACACTGGTAT
AAGCAATTTCAGCTCACTT: AGCAATTTCAGCTCACTTA
TTGATCATGCGTGCCACTC: TGATCATGCGTGCCACTCA
AGATTTTCCGTATTCAAGC: GATTTTCCGTATTCAAGCA
CAACCTGCGGAGCTTACCT: AACCTGCGGAGCTTACCTA
CAAACTATCCTTAATACTT: AAACTATCCTTAATACTTG
CTCATACGGGGTCATTTAC: TCATACGGGGTCATTTACG
GAGCACCCAAGTTAATCAC: AGCACCCAAGTTAATCACA
GCTAACGTCCCCTAGCAAC: CTAACGTCCCCTAGCAACG
TAATCTTTACGCACCTAGG: AATCTTTACGCACCTAGGC
CATACCAGGCCGTTCTTAC: ATACCAGGCCGTTCTTACG
GTCAGCTGGTAGCGCTAGG: TCAGCTGGTAGCGCTAGGT
GTTGGAGTGAGACAACGCA: TTGGAGTGAGACAACGCAT
ATGCGTGCCACTCAATGTA: TGCGTGCCACTCAATGTAG
GCTATGGGACGGCTACGAA: CTATGGGACGGCTACGAAT
ACCCAAGTTTGAAAAGTGG: CCCAAGTTTGAAAAGTGGC
TGCAAACTATCCTTAATAC: GCAAACTATCCTTAATACT
CTCTGGCGGCACGTCGAAA: TCTGGCGGCACGTCGAAAA
GGTCTTTTTGTGTGACTAT: GTCTTTTTGTGTGACTATC
AACTAATATGTCGTCCACC: ACTAATATGTCGTCCACCT
CATGGCGGGCTTCGACTGT: ATGGCGGGCTTCGACTGTT
ACGAATTTAGCAAGCGAAT: CGAATTTAGCAAGCGAATT
CCTTGTCGATTTTCCGTAT: CTTGTCGATTTTCCGTATT
ATGTCAATACGATAGGCAT: TGTCAATACGATAGGCATA
CTTTTTGTGTGACTATCTG: TTTTTGTGTGACTATCTGA
TTCCGGGCGGGATAGAGTC: TCCGGGCGGGATAGAGTCA
TTTTCCGTATTCAAGCAAC: TTTCCGTATTCAAGCAACT
CGAGCAAATTAAAACACTG: GAGCAAATTAAAACACTGG
CCGGTTGGAAGGCTTTCGC: CGGTTGGAAGGCTTTCGCA
GGCACGTGGGGGGGGTGCT: GCACGTGGGGGGGGTGCTA
CAATCGGATTGGTCGAAGT: AATCGGATTGGTCGAAGTA
CGGGCGGTTATCACGTAAA: GGGCGGTTATCACGTAAAT
CACCCAAGTTAATCACAGA: ACCCAAGTTAATCACAGAT
CGTCGCTGGACGTGTCAGG: GTCGCTGGACGTGTCAGGC
TGGCTCTTTGAATGAGAGT: GGCTCTTTGAATGAGAGTG
TCACCTGTTAGGTGGAGTC: CACCTGTTAGGTGGAGTCG
ATCGCAATCGGATTGGTCG: TCGCAATCGGATTGGTCGA
GACTATCTGAGAAAGAACC: ACTATCTGAGAAAGAACCG
ACTTGGAACACAATTCTGC: CTTGGAACACAATTCTGCC
TACTACCGCCAACCTGCCG: ACTACCGCCAACCTGCCGG
CGAATCGTAGTGAAACCCA: GAATCGTAGTGAAACCCAC
TTGAGGTGATTTTCCGTAT: TGAGGTGATTTTCCGTATT
GGTAACGGGGACAGGCACG: GTAACGGGGACAGGCACGT
TTAATTTCTTTGAAGTACA: TAATTTCTTTGAAGTACAG
GCGGTGCATGACTGATAGA: CGGTGCATGACTGATAGAG
GAGTGCGTTGTTAATCCTG: AGTGCGTTGTTAATCCTGT
CGCAATCGGATTGGTCGAA: GCAATCGGATTGGTCGAAG
GTTCAAAGTCGCGACGGAG: TTCAAAGTCGCGACGGAGA
ACCCCCTTAATTTCTTTGA: CCCCCTTAATTTCTTTGAA
GCCCTTGCAACTTGTCGTT: CCCTTGCAACTTGTCGTTA
CCATTCAGCTTTGAGGTGA: CATTCAGCTTTGAGGTGAT
TCCGTATTCAAGCCGAATC: CCGTATTCAAGCCGAATCC
AGACGGAGGAAGCAATTTC: GACGGAGGAAGCAATTTCA
AGTGGAAAAGCACGGCATA: GTGGAAAAGCACGGCATAA
TAAGCACCTAGTTGCAAAC: AAGCACCTAGTTGCAAACT
GGGACGCGAAGGGTGAATG: GGACGCGAAGGGTGAATGG
AATAACGGGCTGTCGCCCT: ATAACGGGCTGTCGCCCTT
CTACTAATTACCGGGGCTA: TACTAATTACCGGGGCTAA
TATTTAAGGCGGTTATGAG: ATTTAAGGCGGTTATGAGA
ACGGGGTCATTTACGAAGC: CGGGGTCATTTACGAAGCA
GCATAATCTTTACGCACCT: CATAATCTTTACGCACCTA
GATCCAAACCGCGTACAAA: ATCCAAACCGCGTACAAAC
CGCGATGTCAATACGATAG: GCGATGTCAATACGATAGG
TGACGGAGCATGCGGGGGA: GACGGAGCATGCGGGGGAC
CATAGGCCCCTCGCATTTA: ATAGGCCCCTCGCATTTAG
TTGCGGGCGGTTATCACGT: TGCGGGCGGTTATCACGTA
GGATTTGAGCATTATTGGT: GATTTGAGCATTATTGGTT
TCTGTATAGAGCGATGTGA: CTGTATAGAGCGATGTGAT
ATGGACTGATCTGTATAGA: TGGACTGATCTGTATAGAG
GACGGAGCATGCGGGGGAC: ACGGAGCATGCGGGGGACG
ATTTTCCGTATTCAAGCCG: TTTTCCGTATTCAAGCCGA
CGGATGTCGACAAAAGCAC: GGATGTCGACAAAAGCACG
AGGAAGCAATTTCAGCTCA: GGAAGCAATTTCAGCTCAC
CAAGCAACTACTGTCCAAA: AAGCAACTACTGTCCAAAG
ATATAGACCGGTCTTTTTG: TATAGACCGGTCTTTTTGT
TTAATACTTGCCAGTCACC: TAATACTTGCCAGTCACCG
AATCACAGATTTTCCGTAT: ATCACAGATTTTCCGTATT
AGCTGCCAAGTGGAAAAGC: GCTGCCAAGTGGAAAAGCA
AATATGTCGTCCACCTCCT: ATATGTCGTCCACCTCCTA
GAAGGGTGAATGGTCTTCT: AAGGGTGAATGGTCTTCTA
GGTGCATGACTGATAGAGG: GTGCATGACTGATAGAGGG
GGTCTTCTACGGGGGTCCT: GTCTTCTACGGGGGTCCTA
AGTTCAAAGTCGCGACGGA: GTTCAAAGTCGCGACGGAG
GGCCGTTCTTACGGACCAT: GCCGTTCTTACGGACCATT
GCGTGAGAGCCCGTCAACT: CGTGAGAGCCCGTCAACTT
CTATTTAAGGCGGTTATGA: TATTTAAGGCGGTTATGAG
GTCAACTTTTCCTGTGGGT: TCAACTTTTCCTGTGGGTA
CCACGTCACGTTTAAAAGT: CACGTCACGTTTAAAAGTA
TTACGGACCATTACCATAG: TACGGACCATTACCATAGG
TCACTTACATACGCTTGGG: CACTTACATACGCTTGGGT
CATACGGGGTCATTTACGA: ATACGGGGTCATTTACGAA
GCTACGAATCGTAGTGAAA: CTACGAATCGTAGTGAAAC
AAAAGCACGGCATAATCTT: AAAGCACGGCATAATCTTT AAAGCACGGCATAATCTTT AAAGCACGGCATAATCTTT
TTTTCGCTCCGTCCGGGAC: TTTCGCTCCGTCCGGGACA
AAATCTAGCAGCACACTTG: AATCTAGCAGCACACTTGG
ACCATCAGCTACTAATTAC: CCATCAGCTACTAATTACC
ACAGTTCGTCTGGCGTATC: CAGTTCGTCTGGCGTATCT
AAGCAACTACTGTCCAAAG: AGCAACTACTGTCCAAAGC
ATACGTCTGTTCCCTCGAT: TACGTCTGTTCCCTCGATT
CCTCTAAAGAGCACAACAA: CTCTAAAGAGCACAACAAC
CGGCACGTCGAAAACTTTA: GGCACGTCGAAAACTTTAC
AGCACGGCATAATCTTTAT: GCACGGCATAATCTTTATT
GAGAACAGTCTAGTGCGCG: AGAACAGTCTAGTGCGCGA
GTGAGACAACGCATGGACT: TGAGACAACGCATGGACTG
TGCCCATGGAGGATGATGT: GCCCATGGAGGATGATGTC
CGGGGTCATTTACGAAGCA: GGGGTCATTTACGAAGCAA
CCTTGCAACTTGTCGTTAC: CTTGCAACTTGTCGTTACC
CCCTCGATTATAGATCCGA: CCTCGATTATAGATCCGAG
CTATCCTTAATACTTGCCA: TATCCTTAATACTTGCCAG
TTTGTTCTCTGGCGGCACG: TTGTTCTCTGGCGGCACGT
GGATTCAGGGCAAAATAAC: GATTCAGGGCAAAATAACG
CCCCTTAATTTCTTTGAAG: CCCTTAATTTCTTTGAAGT
ATAGCTCCCACCTCCCATA: TAGCTCCCACCTCCCATAT
TGTGCCTACTGCGCGATTA: GTGCCTACTGCGCGATTAT
CATTAAACATGGTCCGGAT: ATTAAACATGGTCCGGATC
ATAGATCCGAGCCTTTACA: TAGATCCGAGCCTTTACAG
TAATACCAGTTCTAAGGAT: AATACCAGTTCTAAGGATT
ACAGATTTTCCGTATTCAA: CAGATTTTCCGTATTCAAG
TGTGACTATCTGAGAAAGA: GTGACTATCTGAGAAAGAA
CTTACATTGGAACCCCCCA: TTACATTGGAACCCCCCAA
ACAGGCACGTGGGGGGGGT: CAGGCACGTGGGGGGGGTG
CCCATATCCTTGTCGATTT: CCATATCCTTGTCGATTTT
ATCATCGAGTCAGCCATTC: TCATCGAGTCAGCCATTCA
TATGCCCGGGCGTGAGAGC: ATGCCCGGGCGTGAGAGCC
CATGACTGATAGAGGGCCC: ATGACTGATAGAGGGCCCG
GATTCTTGTTTCCTGCTAT: ATTCTTGTTTCCTGCTATG
TATTTGGTGAGTGTCATCC: ATTTGGTGAGTGTCATCCG
AACTCAACCTGCGGAGCTT: ACTCAACCTGCGGAGCTTA
CCCCCAACCGGCGGTGCAT: CCCCAACCGGCGGTGCATG
GGGTGGACGCACGGAGTAA: GGTGGACGCACGGAGTAAG
ACTGATCTGTATAGAGCGA: CTGATCTGTATAGAGCGAT
AACACATTGTGCTTTCCAT: ACACATTGTGCTTTCCATC
CGCACGGAGTAAGTAGTGG: GCACGGAGTAAGTAGTGGC
ACGAAGCAATCATCGAGTC: CGAAGCAATCATCGAGTCA
GCACCTAGTTGCAAACTAT: CACCTAGTTGCAAACTATC
ATGGTCTTCTACGGGGGTC: TGGTCTTCTACGGGGGTCC
CCAACCGGCGGTGCATGAC: CAACCGGCGGTGCATGACT
GACGGCTACGAATCGTAGT: ACGGCTACGAATCGTAGTG
TTCAGGGCAAAATAACGGG: TCAGGGCAAAATAACGGGC
TGGAACTAATATGTCGTCC: GGAACTAATATGTCGTCCA
GATCCGCCATTCTTAGGTC: ATCCGCCATTCTTAGGTCC
ACCGGCGGTGCATGACTGA: CCGGCGGTGCATGACTGAT
CTAGAGCTCGTATATAGAC: TAGAGCTCGTATATAGACC
AATTTCAGCTCACTTACAT: ATTTCAGCTCACTTACATA
GTTGTTAATCCTGTTGTAA: TTGTTAATCCTGTTGTAAG
TAATCTTTTACGCACTCCG: AATCTTTTACGCACTCCGG
TCCAGTCCAGTAATACGCA: CCAGTCCAGTAATACGCAG
CGATGTGATAACTATCCCT: GATGTGATAACTATCCCTA
CGTCACGTTTAAAAGTATG: GTCACGTTTAAAAGTATGA
TCTCAATGTGCCTACTGCG: CTCAATGTGCCTACTGCGC
TCAATGTAGGTTTTAATGT: CAATGTAGGTTTTAATGTC
TATTCAAGCTGCCAAGTGG: ATTCAAGCTGCCAAGTGGA
ATAGACCGGTCTTTTTGTG: TAGACCGGTCTTTTTGTGT
GCATGCATGGCGGGCTTCG: CATGCATGGCGGGCTTCGA
ACGGCTACGAATCGTAGTG: CGGCTACGAATCGTAGTGA
ATATTTGGTGAGTGTCATC: TATTTGGTGAGTGTCATCC
AGGCCCCTCGCATTTAGAT: GGCCCCTCGCATTTAGATA
GCGGAGCTTACCTAGAGCT: CGGAGCTTACCTAGAGCTC
AGTTAATCACAGATTTTCC: GTTAATCACAGATTTTCCG
CCTTGCGGGCGGTTATCAC: CTTGCGGGCGGTTATCACG
ATTGGATTTTCCGTATTCA: TTGGATTTTCCGTATTCAA
TTAAGGCGGTTATGAGATC: TAAGGCGGTTATGAGATCA
GTTTGAAAAGTGGCATGCA: TTTGAAAAGTGGCATGCAT
CTGATAGAGGGCCCGGCCT: TGATAGAGGGCCCGGCCTG
GGAGTAAGTAGTGGCTCAA: GAGTAAGTAGTGGCTCAAG
CGTATCTCAATGTGCCTAC: GTATCTCAATGTGCCTACT
ACACGGTGATCCAAACCGC: CACGGTGATCCAAACCGCG
CAAGAGAAGCGGAGCCATG: AAGAGAAGCGGAGCCATGG
TTTACGCACCTAGGCGTTG: TTACGCACCTAGGCGTTGG
AGTCCCTTGCGGGCGGTTA: GTCCCTTGCGGGCGGTTAT
CACAAACTGTCCCCATTAA: ACAAACTGTCCCCATTAAG
AGCACAACAACTGTCTCAT: GCACAACAACTGTCTCATA
CTCCTCACCTCAACGTCCT: TCCTCACCTCAACGTCCTC
TAGAGTTCAAAGTCGCGAC: AGAGTTCAAAGTCGCGACG
ATGTGCCTACTGCGCGATT: TGTGCCTACTGCGCGATTA
TCTCTGAGGGACTCGCTTA: CTCTGAGGGACTCGCTTAA
GTCGCGACGGAGACGGAGG: TCGCGACGGAGACGGAGGA
TGGTTCAAGGGTGGACGCA: GGTTCAAGGGTGGACGCAC
GTTGTAACGCGAACCTTGA: TTGTAACGCGAACCTTGAA
CACAGGTATCGGGATCCGC: ACAGGTATCGGGATCCGCC
TTATTGGTTATACGTCTGT: TATTGGTTATACGTCTGTT
TGAGGGACTCGCTTAACAG: GAGGGACTCGCTTAACAGT
CTCCTACTGGTTGTTGTAA: TCCTACTGGTTGTTGTAAC
TCATGCGTGCCACTCAATG: CATGCGTGCCACTCAATGT
ATTCAGGGCAAAATAACGG: TTCAGGGCAAAATAACGGG
CTTTGACGGAGCATGCGGG: TTTGACGGAGCATGCGGGG
ACGCGAAAGCACCTGGCCC: CGCGAAAGCACCTGGCCCA
CTGTTTTCGCTCCGTCCGG: TGTTTTCGCTCCGTCCGGG
GAGCCATGGATTCTTGTTT: AGCCATGGATTCTTGTTTC
TTCCGTATTCAAGCTGCCA: TCCGTATTCAAGCTGCCAA
TCCACCTCCTACTGGTTGT: CCACCTCCTACTGGTTGTT
CCAGGCCGTTCTTACGGAC: CAGGCCGTTCTTACGGACC
CTATCTGAGAAAGAACCGA: TATCTGAGAAAGAACCGAA
TGACCATCAGCTACTAATT: GACCATCAGCTACTAATTA
CAATGTGCCTACTGCGCGA: AATGTGCCTACTGCGCGAT
CGAAAGCACCTGGCCCACA: GAAAGCACCTGGCCCACAG
AGGTGATTTTCCGTATTCA: GGTGATTTTCCGTATTCAA
GGCTTTCGCATCTCCTCAC: GCTTTCGCATCTCCTCACC
TTACAGGGTTTTGTTCTCT: TACAGGGTTTTGTTCTCTG
TCTTAGGTCCAGTCCAGTA: CTTAGGTCCAGTCCAGTAA
CACGGTGATCCAAACCGCG: ACGGTGATCCAAACCGCGT
AGGGACTCGCTTAACAGTT: GGGACTCGCTTAACAGTTC
GGAGGATGATGTCTACTAC: GAGGATGATGTCTACTACC
TCCAAACCGCGTACAAACT: CCAAACCGCGTACAAACTC
GCGCGATGTCAATACGATA: CGCGATGTCAATACGATAG
GGTTCTGTGGAACTAATAT: GTTCTGTGGAACTAATATG
CTTTACAGGGTTTTGTTCT: TTTACAGGGTTTTGTTCTC
TTCAAGCGGATGTCGACAA: TCAAGCGGATGTCGACAAA
GTCGAAAACTTTACCACCG: TCGAAAACTTTACCACCGG
GGAGAACAGTCTAGTGCGC: GAGAACAGTCTAGTGCGCG
CCCTAAAAAGCACGGCATA: CCTAAAAAGCACGGCATAA
ATACGCAGAAGGAGAACAG: TACGCAGAAGGAGAACAGT
TTTGAATGAGAGTGCTGGC: TTGAATGAGAGTGCTGGCG
GTCTGGCGTATCTCAATGT: TCTGGCGTATCTCAATGTG
AAGAACCGAATCCCCTTTA: AGAACCGAATCCCCTTTAT
GTGCTGGCGATTCCCAACT: TGCTGGCGATTCCCAACTG
GTTTTGTTCTCTGGCGGCA: TTTTGTTCTCTGGCGGCAC
CATCTCCTCACCTCAACGT: ATCTCCTCACCTCAACGTC
TGAGCATTATTGGTTATAC: GAGCATTATTGGTTATACG
TTTACGAAGCAATCATCGA: TTACGAAGCAATCATCGAG
AACAGTCTAGTGCGCGATG: ACAGTCTAGTGCGCGATGT
GGCGGTTATCACGTAAATA: GCGGTTATCACGTAAATAC
GACAACGCATGGACTGATC: ACAACGCATGGACTGATCT
ACCTTGTCGGAGCTCAAGG: CCTTGTCGGAGCTCAAGGT
CGCGAAAGCACCTGGCCCA: GCGAAAGCACCTGGCCCAC
TCAATGTGCCTACTGCGCG: CAATGTGCCTACTGCGCGA
CGTATTCAAGCGGATGTCG: GTATTCAAGCGGATGTCGA
AGAAAGAACCGAATCCCCT: GAAAGAACCGAATCCCCTT
TTTTCCGTATTCAAGCTGC: TTTCCGTATTCAAGCTGCC
TCCCCAAAATCGCAATCGG: CCCCAAAATCGCAATCGGA
AGTGACACGGTGATCCAAA: GTGACACGGTGATCCAAAC
AAGTATGATATAGAGTTCA: AGTATGATATAGAGTTCAA
CCTGTTGTAAGGCGTACCC: CTGTTGTAAGGCGTACCCA
CCAAACCGCGTACAAACTC: CAAACCGCGTACAAACTCA
TTTGACCATCAGCTACTAA: TTGACCATCAGCTACTAAT
GTATATAGACCGGTCTTTT: TATATAGACCGGTCTTTTT
TTCGCATCTCCTCACCTCA: TCGCATCTCCTCACCTCAA
CGATGTCAATACGATAGGC: GATGTCAATACGATAGGCA
GTAGCGCTAGGTTAAATCT: TAGCGCTAGGTTAAATCTA
ACAACGCATGGACTGATCT: CAACGCATGGACTGATCTG
GCATAATCTTTATTGGATT: CATAATCTTTATTGGATTT
TATCCTTGTCGATTTTCCG: ATCCTTGTCGATTTTCCGT
GGAGACGGAGGAAGCAATT: GAGACGGAGGAAGCAATTT
CTAAAGAGCACAACAACTG: TAAAGAGCACAACAACTGT
TGTAAGGCGTACCCAAGTT: GTAAGGCGTACCCAAGTTT
GGACTGATCTGTATAGAGC: GACTGATCTGTATAGAGCG
GTCGCTGGACGTGTCAGGC: TCGCTGGACGTGTCAGGCA
CGCCATTCTTAGGTCCAGT: GCCATTCTTAGGTCCAGTC
ACTATCCCTATTTAAGGCG: CTATCCCTATTTAAGGCGG
AATCTTTATTGGATTTTCC: ATCTTTATTGGATTTTCCG
AAGTAGTGGCTCAAGCCGA: AGTAGTGGCTCAAGCCGAG
GTAATACGCAGAAGGAGAA: TAATACGCAGAAGGAGAAC
TGAAAAGTGGCATGCATGG: GAAAAGTGGCATGCATGGC
ATAACTATCCCTATTTAAG: TAACTATCCCTATTTAAGG
TGAGTGTCATCCGGTTGGA: GAGTGTCATCCGGTTGGAA
CTAGCAGCACACTTGGAAC: TAGCAGCACACTTGGAACA
TAGGTTTTAATGTCGACCC: AGGTTTTAATGTCGACCCC
AGCACCCAAGTTAATCACA: GCACCCAAGTTAATCACAG
GAGTAAGTAGTGGCTCAAG: AGTAAGTAGTGGCTCAAGC
CTGCGCGATTATGGTCCCC: TGCGCGATTATGGTCCCCA
ACCTGCGGAGCTTACCTAG: CCTGCGGAGCTTACCTAGA
GGCGTACCCAAGTTTGAAA: GCGTACCCAAGTTTGAAAA
ACGCACTCCGGAGCCATCC: CGCACTCCGGAGCCATCCA
CCGTCAACTTTTCCTGTGG: CGTCAACTTTTCCTGTGGG
TTTGATCTGCTATCGAAAC: TTGATCTGCTATCGAAACA
CCTCAGTTCCCCAAAATCG: CTCAGTTCCCCAAAATCGC
ATATAGAGTTCAAAGTCGC: TATAGAGTTCAAAGTCGCG
TCTAGTGCGCGATGTCAAT: CTAGTGCGCGATGTCAATA
TTAACAGTTCGTCTGGCGT: TAACAGTTCGTCTGGCGTA
GGCATAATCTTTATTGGAT: GCATAATCTTTATTGGATT
GCATGGCGGGCTTCGACTG: CATGGCGGGCTTCGACTGT
AGCTAAGATTTGATCTGCT: GCTAAGATTTGATCTGCTA
AAGCAATCATCGAGTCAGC: AGCAATCATCGAGTCAGCC
GCTGTCGCCCTTGCAACTT: CTGTCGCCCTTGCAACTTG
CGGGCCTCTAAGCAAATTG: GGGCCTCTAAGCAAATTGG
GCATCTCCTCACCTCAACG: CATCTCCTCACCTCAACGT
ACAAGTTAATCGCCGGACG: CAAGTTAATCGCCGGACGC
GGTCCTACTAACGCGAAAG: GTCCTACTAACGCGAAAGC
GGCATATGCCCGGGCGTGA: GCATATGCCCGGGCGTGAG
AATGAGAGTGCTGGCGATT: ATGAGAGTGCTGGCGATTC
AATACTTGCCAGTCACCGT: ATACTTGCCAGTCACCGTA
TATATGCCTGCGGATTCAG: ATATGCCTGCGGATTCAGG
CCCACGTCACGTTTAAAAG: CCACGTCACGTTTAAAAGT
GATTGGTCGAAGTATACTT: ATTGGTCGAAGTATACTTT
TACGAAGCAATCATCGAGT: ACGAAGCAATCATCGAGTC
CATCCGGTTGGAAGGCTTT: ATCCGGTTGGAAGGCTTTC
TACGCTTGGGTAACGGGGA: ACGCTTGGGTAACGGGGAC
GGTGGAGTCGAGCAAATTA: GTGGAGTCGAGCAAATTAA
CATCCATCGAGACAGCTTT: ATCCATCGAGACAGCTTTA
GCCCGTCAACTTTTCCTGT: CCCGTCAACTTTTCCTGTG
CAAGCTGCCAAGTGGAAAA: AAGCTGCCAAGTGGAAAAG
AGATCCGAGCCTTTACAGG: GATCCGAGCCTTTACAGGG
CCCAAGTTTGAAAAGTGGC: CCAAGTTTGAAAAGTGGCA
AAATAACGGGCTGTCGCCC: AATAACGGGCTGTCGCCCT
GTATACTTTGACCATCAGC: TATACTTTGACCATCAGCT
TATATTTGGTGAGTGTCAT: ATATTTGGTGAGTGTCATC
CAACTGGTTCAAGGGTGGA: AACTGGTTCAAGGGTGGAC
CATATGCCCGGGCGTGAGA: ATATGCCCGGGCGTGAGAG
TGGCATGCATGGCGGGCTT: GGCATGCATGGCGGGCTTC
GTCGTCCACCTCCTACTGG: TCGTCCACCTCCTACTGGT
GCCCGGGCGTGAGAGCCCG: CCCGGGCGTGAGAGCCCGT
GGGTCCTACTAACGCGAAA: GGTCCTACTAACGCGAAAG
AAATACACTTATAAAGTGA: AATACACTTATAAAGTGAG
CACATTGTGCTTTCCATCA: ACATTGTGCTTTCCATCAC
CAGCTTTATATGCCTGCGG: AGCTTTATATGCCTGCGGA
CCTCCCATATCCTTGTCGA: CTCCCATATCCTTGTCGAT
ATCCCTAAAAAGCACGGCA: TCCCTAAAAAGCACGGCAT
ACTCGCTTAACAGTTCGTC: CTCGCTTAACAGTTCGTCT
TACTGGTTGTTGTAACGCG: ACTGGTTGTTGTAACGCGA
TGGTTATACGTCTGTTCCC: GGTTATACGTCTGTTCCCT
CACCTAGTTGCAAACTATC: ACCTAGTTGCAAACTATCC
GACTCGCTTAACAGTTCGT: ACTCGCTTAACAGTTCGTC
CGAGCCTTTACAGGGTTTT: GAGCCTTTACAGGGTTTTG
CCGTCCGGGACAAGAGAAG: CGTCCGGGACAAGAGAAGC
CACAATTCTGCCCATGGAG: ACAATTCTGCCCATGGAGG
GTTTTCGCTCCGTCCGGGA: TTTTCGCTCCGTCCGGGAC
GGACAAGAGAAGCGGAGCC: GACAAGAGAAGCGGAGCCA
TAGGTCCAGTCCAGTAATA: AGGTCCAGTCCAGTAATAC
AGGGCAAAATAACGGGCTG: GGGCAAAATAACGGGCTGT
CATTGTGCTTTCCATCACC: ATTGTGCTTTCCATCACCT
AGCAAATTAAAACACTGGT: GCAAATTAAAACACTGGTA
GAACAGTCTAGTGCGCGAT: AACAGTCTAGTGCGCGATG
ACCCACCTCAGTTCCCCAA: CCCACCTCAGTTCCCCAAA
ATCCCTATTTAAGGCGGTT: TCCCTATTTAAGGCGGTTA
TTTTCCGTATTCAAGCGGA: TTTCCGTATTCAAGCGGAT
AATACCAGTTCTAAGGATT: ATACCAGTTCTAAGGATTT
AAGGGTGAATGGTCTTCTA: AGGGTGAATGGTCTTCTAC
GCGGGCGGTTATCACGTAA: CGGGCGGTTATCACGTAAA
CTAGCACCACTTCTTACAT: TAGCACCACTTCTTACATT
CCGAGCTTCATACCAGGCC: CGAGCTTCATACCAGGCCG
CATACGCTTGGGTAACGGG: ATACGCTTGGGTAACGGGG
GCGATTCCCAACTGGTTCA: CGATTCCCAACTGGTTCAA
TCGATTTTCCGTATTCAAG: CGATTTTCCGTATTCAAGC
TGGTAATACCAGTTCTAAG: GGTAATACCAGTTCTAAGG
AGCATTATTGGTTATACGT: GCATTATTGGTTATACGTC
TGTCGACAAAAGCACGGCA: GTCGACAAAAGCACGGCAT
GTATGATATAGAGTTCAAA: TATGATATAGAGTTCAAAG
TAATCTTTGACGGAGCATG: AATCTTTGACGGAGCATGC
GGGGAGCACCCAAGTTAAT: GGGAGCACCCAAGTTAATC
GCTCGTATATAGACCGGTC: CTCGTATATAGACCGGTCT
ACATACGCTTGGGTAACGG: CATACGCTTGGGTAACGGG
ACCTGCCGGGCCTCTAAGC: CCTGCCGGGCCTCTAAGCA
TACGGGGTCATTTACGAAG: ACGGGGTCATTTACGAAGC
TCAATACGATAGGCATATG: CAATACGATAGGCATATGC
ATCGCCGGACGCGAGCTAA: TCGCCGGACGCGAGCTAAG
CACAACAACTGTCTCATAC: ACAACAACTGTCTCATACG
GCATGACTGATAGAGGGCC: CATGACTGATAGAGGGCCC
GCACCTGGCCCACAGGTAT: CACCTGGCCCACAGGTATC
GCCTGGCTCTTTGAATGAG: CCTGGCTCTTTGAATGAGA
AAAACACTGGTATATTTGG: AAACACTGGTATATTTGGT
TTCCGTATTCAAGCCGAAT: TCCGTATTCAAGCCGAATC
TTCCATCACCTGTTAGGTG: TCCATCACCTGTTAGGTGG
CGCATCTCCTCACCTCAAC: GCATCTCCTCACCTCAACG
TAGTGAAACCCACCTCAGT: AGTGAAACCCACCTCAGTT
AACCGCGTACAAACTCAAC: ACCGCGTACAAACTCAACC
CCTCGATTATAGATCCGAG: CTCGATTATAGATCCGAGC
GTGTGACTATCTGAGAAAG: TGTGACTATCTGAGAAAGA
AAGCCGAATCCCTAAAAAG: AGCCGAATCCCTAAAAAGC
TTACATACGCTTGGGTAAC: TACATACGCTTGGGTAACG
AGTGGCATGCATGGCGGGC: GTGGCATGCATGGCGGGCT
CGGCATAATCTTTATTGGA: GGCATAATCTTTATTGGAT
ATTGGAACCCCCCAACCGG: TTGGAACCCCCCAACCGGC
CTAACGCGAAAGCACCTGG: TAACGCGAAAGCACCTGGC
GTTAGTCCGGTTCTGTGGA: TTAGTCCGGTTCTGTGGAA
CCTCTAAGCAAATTGGTAA: CTCTAAGCAAATTGGTAAT
ACGTCCTCTAAAGAGCACA: CGTCCTCTAAAGAGCACAA
CAAGCGAATTTTCCCTTGA: AAGCGAATTTTCCCTTGAT
GTTTCCTGCTATGGGACGG: TTTCCTGCTATGGGACGGC
TTTTGTGTGACTATCTGAG: TTTGTGTGACTATCTGAGA
GTCACCGTAGGCAAGGGGC: TCACCGTAGGCAAGGGGCC
CTCGTATATAGACCGGTCT: TCGTATATAGACCGGTCTT
ATTATGGTCCCCACGTCAC: TTATGGTCCCCACGTCACG
TACGCACTCCGGAGCCATC: ACGCACTCCGGAGCCATCC
GGGGCTAACGTCCCCTAGC: GGGCTAACGTCCCCTAGCA
TACGAATCGTAGTGAAACC: ACGAATCGTAGTGAAACCC
ACAAACTGTCCCCATTAAG: CAAACTGTCCCCATTAAGC
TCAGCTTTGAGGTGATTTT: CAGCTTTGAGGTGATTTTC
TCCGAGCCTTTACAGGGTT: CCGAGCCTTTACAGGGTTT
CAGCTGGTAGCGCTAGGTT: AGCTGGTAGCGCTAGGTTA
TACGCAGAAGGAGAACAGT: ACGCAGAAGGAGAACAGTC
TTATCACGTAAATACACTT: TATCACGTAAATACACTTA
ACCAGGCCGTTCTTACGGA: CCAGGCCGTTCTTACGGAC
TGTCGACCCCCTTAATTTC: GTCGACCCCCTTAATTTCT
CTACGGGGGTCCTACTAAC: TACGGGGGTCCTACTAACG
GAGTGAGACAACGCATGGA: AGTGAGACAACGCATGGAC
TTACGCACCTAGGCGTTGG: TACGCACCTAGGCGTTGGA
TCTTTTTGTGTGACTATCT: CTTTTTGTGTGACTATCTG
TAGTGCGCGATGTCAATAC: AGTGCGCGATGTCAATACG
GACGGAGGAAGCAATTTCA: ACGGAGGAAGCAATTTCAG
CGTGGGGGGGGTGCTAGCA: GTGGGGGGGGTGCTAGCAC
CTCCCATATCCTTGTCGAT: TCCCATATCCTTGTCGATT
GGTTAAATCTAGCAGCACA: GTTAAATCTAGCAGCACAC
GGGATCCGCCATTCTTAGG: GGATCCGCCATTCTTAGGT
ATCGAGACAGCTTTATATG: TCGAGACAGCTTTATATGC
CCGAATCCCCTTTATTAAA: CGAATCCCCTTTATTAAAG
TTATAAAGTGAGTGCGTTG: TATAAAGTGAGTGCGTTGT
ACCACTTCTTACATTGGAA: CCACTTCTTACATTGGAAC
AATTGGTAATACCAGTTCT: ATTGGTAATACCAGTTCTA
TTACCGGGGCTAACGTCCC: TACCGGGGCTAACGTCCCC
TAGATCCGAGCCTTTACAG: AGATCCGAGCCTTTACAGG
TTAGTCCGGTTCTGTGGAA: TAGTCCGGTTCTGTGGAAC
GAAGTACAGTGACACGGTG: AAGTACAGTGACACGGTGA
TATGTCGTCCACCTCCTAC: ATGTCGTCCACCTCCTACT
TTGGTTATACGTCTGTTCC: TGGTTATACGTCTGTTCCC
GCTGGACGTGTCAGGCATC: CTGGACGTGTCAGGCATCC
GCCAACCTGCCGGGCCTCT: CCAACCTGCCGGGCCTCTA
AAATTAAAACACTGGTATA: AATTAAAACACTGGTATAT
GGTGGACGCACGGAGTAAG: GTGGACGCACGGAGTAAGT
TCTCTGGCGGCACGTCGAA: CTCTGGCGGCACGTCGAAA
ACGGGGAGCACCCAAGTTA: CGGGGAGCACCCAAGTTAA
TAAAACACTGGTATATTTG: AAAACACTGGTATATTTGG
TAACGCGAACCTTGAACGG: AACGCGAACCTTGAACGGG
GTGATAACTATCCCTATTT: TGATAACTATCCCTATTTA
ACTAACGCGAAAGCACCTG: CTAACGCGAAAGCACCTGG
TCCGGAGCCATCCATCGAG: CCGGAGCCATCCATCGAGA
CTGTGGGTACACGGGGAGC: TGTGGGTACACGGGGAGCA
CTAGGTTAAATCTAGCAGC: TAGGTTAAATCTAGCAGCA
AACTTGTCGTTACCTTGTC: ACTTGTCGTTACCTTGTCG
CTAAAAAGCACGGCATAAT: TAAAAAGCACGGCATAATC
AACTTTTCCTGTGGGTACA: ACTTTTCCTGTGGGTACAC
TACCCAAGTTTGAAAAGTG: ACCCAAGTTTGAAAAGTGG
ACCTTGAACGGGCCTCATT: CCTTGAACGGGCCTCATTA
GTGGAACTAATATGTCGTC: TGGAACTAATATGTCGTCC
GGTGAATGGTCTTCTACGG: GTGAATGGTCTTCTACGGG
ACTTTACCACCGGTCTCTG: CTTTACCACCGGTCTCTGA
CAGTGACACGGTGATCCAA: AGTGACACGGTGATCCAAA
CACGTAAATACACTTATAA: ACGTAAATACACTTATAAA
CAAAGTCGCGACGGAGACG: AAAGTCGCGACGGAGACGG
GACGTGTCAGGCATCCGGT: ACGTGTCAGGCATCCGGTA
ACTACCGCCAACCTGCCGG: CTACCGCCAACCTGCCGGG
TTCTACGGGGGTCCTACTA: TCTACGGGGGTCCTACTAA
AAGCACGGCATAATCTTTG: AGCACGGCATAATCTTTGA
ACGCAGAAGGAGAACAGTC: CGCAGAAGGAGAACAGTCT
GCCGAATCCCTAAAAAGCA: CCGAATCCCTAAAAAGCAC
CTTTCGCATCTCCTCACCT: TTTCGCATCTCCTCACCTC
GACCCCCTTAATTTCTTTG: ACCCCCTTAATTTCTTTGA
AATCTTTTACGCACTCCGG: ATCTTTTACGCACTCCGGA
TATTAAAGCGCTACAAGTT: ATTAAAGCGCTACAAGTTA
TTGTGTGACTATCTGAGAA: TGTGTGACTATCTGAGAAA
GCACGGCATAATCTTTATT: CACGGCATAATCTTTATTG
CCTAAAAAGCACGGCATAA: CTAAAAAGCACGGCATAAT
TACACGGGGAGCACCCAAG: ACACGGGGAGCACCCAAGT
AAAAAGCACGGCATAATCT: AAAAGCACGGCATAATCTT
GGACGCACGGAGTAAGTAG: GACGCACGGAGTAAGTAGT
TAATGTCGACCCCCTTAAT: AATGTCGACCCCCTTAATT
GAAAGAACCGAATCCCCTT: AAAGAACCGAATCCCCTTT
CCCAAAATCGCAATCGGAT: CCAAAATCGCAATCGGATT
AAGTGGCATGCATGGCGGG: AGTGGCATGCATGGCGGGC
GCACGGCATAATCTTTGAC: CACGGCATAATCTTTGACG
ACGGCATAATCTTTATTGG: CGGCATAATCTTTATTGGA
GTTCCCCAAAATCGCAATC: TTCCCCAAAATCGCAATCG
TCACAGATTTTCCGTATTC: CACAGATTTTCCGTATTCA
GCTGCCAAGTGGAAAAGCA: CTGCCAAGTGGAAAAGCAC
CCTGTGGGTACACGGGGAG: CTGTGGGTACACGGGGAGC
GTTACCTTGTCGGAGCTCA: TTACCTTGTCGGAGCTCAA
GTGAAACCCACCTCAGTTC: TGAAACCCACCTCAGTTCC
CCAAGTTTGAAAAGTGGCA: CAAGTTTGAAAAGTGGCAT
GTATATTTGGTGAGTGTCA: TATATTTGGTGAGTGTCAT
CATGCATGGCGGGCTTCGA: ATGCATGGCGGGCTTCGAC
TGCCACTCAATGTAGGTTT: GCCACTCAATGTAGGTTTT
GTTGTAAGGCGTACCCAAG: TTGTAAGGCGTACCCAAGT
AATCGTAGTGAAACCCACC: ATCGTAGTGAAACCCACCT
TCGCATTTAGATAGCTCCC: CGCATTTAGATAGCTCCCA
CACCTCAGTTCCCCAAAAT: ACCTCAGTTCCCCAAAATC
CAGCTACTAATTACCGGGG: AGCTACTAATTACCGGGGC
GAGGGCCCGGCCTGGCTCT: AGGGCCCGGCCTGGCTCTT
AGTTCCCCAAAATCGCAAT: GTTCCCCAAAATCGCAATC
TACATTGGAACCCCCCAAC: ACATTGGAACCCCCCAACC
CCTAGGCGTTGGAGTGAGA: CTAGGCGTTGGAGTGAGAC
CCTAGAGCTCGTATATAGA: CTAGAGCTCGTATATAGAC
AAGTACAGTGACACGGTGA: AGTACAGTGACACGGTGAT
GATTCCCAACTGGTTCAAG: ATTCCCAACTGGTTCAAGG
TGATCTGTATAGAGCGATG: GATCTGTATAGAGCGATGT
GCTCAAGCCGAGCTTCATA: CTCAAGCCGAGCTTCATAC
AGTTCTAAGGATTTGAGCA: GTTCTAAGGATTTGAGCAT
AAGAGAAGCGGAGCCATGG: AGAGAAGCGGAGCCATGGA
GTTCTCTGGCGGCACGTCG: TTCTCTGGCGGCACGTCGA
CCCCACGTCACGTTTAAAA: CCCACGTCACGTTTAAAAG
GTCCAAAGCACGGCATAAT: TCCAAAGCACGGCATAATC
TATTCAAGCCGAATCCCTA: ATTCAAGCCGAATCCCTAA
CAACTTGTCGTTACCTTGT: AACTTGTCGTTACCTTGTC
GTTCCGGGCGGGATAGAGT: TTCCGGGCGGGATAGAGTC
CCAAGTTAATCACAGATTT: CAAGTTAATCACAGATTTT
GCAGTCCCTTGCGGGCGGT: CAGTCCCTTGCGGGCGGTT
AAACTTTACCACCGGTCTC: AACTTTACCACCGGTCTCT
AAAAGTGGCATGCATGGCG: AAAGTGGCATGCATGGCGG
TTAAAAGTATGATATAGAG: TAAAAGTATGATATAGAGT
TATTGGTTATACGTCTGTT: ATTGGTTATACGTCTGTTC
CGCGTACAAACTCAACCTG: GCGTACAAACTCAACCTGC
GCAATTTCAGCTCACTTAC: CAATTTCAGCTCACTTACA
ACTGGTTCAAGGGTGGACG: CTGGTTCAAGGGTGGACGC
CGGTTCTGTGGAACTAATA: GGTTCTGTGGAACTAATAT
TCAAGCTGCCAAGTGGAAA: CAAGCTGCCAAGTGGAAAA
CAAGTTAATCACAGATTTT: AAGTTAATCACAGATTTTC
ACTGGTATATTTGGTGAGT: CTGGTATATTTGGTGAGTG
CATTATTGGTTATACGTCT: ATTATTGGTTATACGTCTG
CAGGGTTTTGTTCTCTGGC: AGGGTTTTGTTCTCTGGCG
TGAGTGCGTTGTTAATCCT: GAGTGCGTTGTTAATCCTG
CTCTTTGAATGAGAGTGCT: TCTTTGAATGAGAGTGCTG
TGCTTTCCATCACCTGTTA: GCTTTCCATCACCTGTTAG
GGGGACGCGAAGGGTGAAT: GGGACGCGAAGGGTGAATG
CGGCATAATCTTTTACGCA: GGCATAATCTTTTACGCAC
ACACATTGTGCTTTCCATC: CACATTGTGCTTTCCATCA
GTCGGAGCTCAAGGTTCCG: TCGGAGCTCAAGGTTCCGG
GGGGGGTGCTAGCACCACT: GGGGGTGCTAGCACCACTT
GCGATGTCAATACGATAGG: CGATGTCAATACGATAGGC
GCGAACCTTGAACGGGCCT: CGAACCTTGAACGGGCCTC
CGGTAGGCAGTCCCTTGCG: GGTAGGCAGTCCCTTGCGG
ACGAATCGTAGTGAAACCC: CGAATCGTAGTGAAACCCA
GCGCTACAAGTTAATCGCC: CGCTACAAGTTAATCGCCG
AGGGTTTTGTTCTCTGGCG: GGGTTTTGTTCTCTGGCGG
TTGTTTCCTGCTATGGGAC: TGTTTCCTGCTATGGGACG
TCGGGATCCGCCATTCTTA: CGGGATCCGCCATTCTTAG
TTATGAGATCACAAACTGT: TATGAGATCACAAACTGTC
CGGAGCATGCGGGGGACGC: GGAGCATGCGGGGGACGCG
ATCCGCCATTCTTAGGTCC: TCCGCCATTCTTAGGTCCA
CCATTCTTAGGTCCAGTCC: CATTCTTAGGTCCAGTCCA
CACGTCGAAAACTTTACCA: ACGTCGAAAACTTTACCAC
GATGTCAATACGATAGGCA: ATGTCAATACGATAGGCAT
GCTTCGACTGTTTTCGCTC: CTTCGACTGTTTTCGCTCC
TTACATTGGAACCCCCCAA: TACATTGGAACCCCCCAAC
TTGGGTAACGGGGACAGGC: TGGGTAACGGGGACAGGCA
CGGCTACGAATCGTAGTGA: GGCTACGAATCGTAGTGAA
TCCCTTGCGGGCGGTTATC: CCCTTGCGGGCGGTTATCA
ATTCCCAACTGGTTCAAGG: TTCCCAACTGGTTCAAGGG
ACCAGTTCTAAGGATTTGA: CCAGTTCTAAGGATTTGAG
CCGTTCTTACGGACCATTA: CGTTCTTACGGACCATTAC
GCCACTCAATGTAGGTTTT: CCACTCAATGTAGGTTTTA
AGTGTCATCCGGTTGGAAG: GTGTCATCCGGTTGGAAGG
CGAGCTAAGATTTGATCTG: GAGCTAAGATTTGATCTGC
CTTTGAAGTACAGTGACAC: TTTGAAGTACAGTGACACG
CTTGATCATGCGTGCCACT: TTGATCATGCGTGCCACTC
CCATCACCTGTTAGGTGGA: CATCACCTGTTAGGTGGAG
AACTGTCTCATACGGGGTC: ACTGTCTCATACGGGGTCA
AACCTGCCGGGCCTCTAAG: ACCTGCCGGGCCTCTAAGC
CGTAAATACACTTATAAAG: GTAAATACACTTATAAAGT
CCCAAGTTAATCACAGATT: CCAAGTTAATCACAGATTT
CTTTCCATCACCTGTTAGG: TTTCCATCACCTGTTAGGT
CTAGGCGTTGGAGTGAGAC: TAGGCGTTGGAGTGAGACA
AGACCGGTCTTTTTGTGTG: GACCGGTCTTTTTGTGTGA
AAGGCTTTCGCATCTCCTC: AGGCTTTCGCATCTCCTCA
TCAAGCCGAGCTTCATACC: CAAGCCGAGCTTCATACCA
TTATAGATCCGAGCCTTTA: TATAGATCCGAGCCTTTAC
TCAGGCATCCGGTAGGCAG: CAGGCATCCGGTAGGCAGT
CCTGTTAGGTGGAGTCGAG: CTGTTAGGTGGAGTCGAGC
TGACTATCTGAGAAAGAAC: GACTATCTGAGAAAGAACC
AGCGAATTTTCCCTTGATC: GCGAATTTTCCCTTGATCA
ATATGCCTGCGGATTCAGG: TATGCCTGCGGATTCAGGG
CTTTATTAAAGCGCTACAA: TTTATTAAAGCGCTACAAG
CCCTTTATTAAAGCGCTAC: CCTTTATTAAAGCGCTACA
CCTACTGGTTGTTGTAACG: CTACTGGTTGTTGTAACGC
GCGCTAGGTTAAATCTAGC: CGCTAGGTTAAATCTAGCA
CCCTAGCAACGAATTTAGC: CCTAGCAACGAATTTAGCA
ACAGTGACACGGTGATCCA: CAGTGACACGGTGATCCAA
TATAGAGCGATGTGATAAC: ATAGAGCGATGTGATAACT
CCTACTGCGCGATTATGGT: CTACTGCGCGATTATGGTC
ATTTGAGCATTATTGGTTA: TTTGAGCATTATTGGTTAT
AAACACTGGTATATTTGGT: AACACTGGTATATTTGGTG
AGAGCTCGTATATAGACCG: GAGCTCGTATATAGACCGG
ATTAAGCACCTAGTTGCAA: TTAAGCACCTAGTTGCAAA
AGTCTAGTGCGCGATGTCA: GTCTAGTGCGCGATGTCAA
TATTGGATTTTCCGTATTC: ATTGGATTTTCCGTATTCA
TCATACCAGGCCGTTCTTA: CATACCAGGCCGTTCTTAC
GGAACTAATATGTCGTCCA: GAACTAATATGTCGTCCAC
CCATCCATCGAGACAGCTT: CATCCATCGAGACAGCTTT
TCCTACTAACGCGAAAGCA: CCTACTAACGCGAAAGCAC
CGGACGCGAGCTAAGATTT: GGACGCGAGCTAAGATTTG
GGGCGGTTATCACGTAAAT: GGCGGTTATCACGTAAATA
TACGATAGGCATATGCCCG: ACGATAGGCATATGCCCGG
ACGTCTGTTCCCTCGATTA: CGTCTGTTCCCTCGATTAT
AGCGGAGCCATGGATTCTT: GCGGAGCCATGGATTCTTG
GCCCCTCGCATTTAGATAG: CCCCTCGCATTTAGATAGC
GTGCCTACTGCGCGATTAT: TGCCTACTGCGCGATTATG
GCGGCACGTCGAAAACTTT: CGGCACGTCGAAAACTTTA
ACTTTGACCATCAGCTACT: CTTTGACCATCAGCTACTA
TGTCTCATACGGGGTCATT: GTCTCATACGGGGTCATTT
TTCAAGCCGAATCCCTAAA: TCAAGCCGAATCCCTAAAA
GCTTACCTAGAGCTCGTAT: CTTACCTAGAGCTCGTATA
TGGTCGAAGTATACTTTGA: GGTCGAAGTATACTTTGAC
AGCTGGTAGCGCTAGGTTA: GCTGGTAGCGCTAGGTTAA
ATAATCTTTATTGGATTTT: TAATCTTTATTGGATTTTC
AGGGCCCGGCCTGGCTCTT: GGGCCCGGCCTGGCTCTTT
CTTAGGTCCAGTCCAGTAA: TTAGGTCCAGTCCAGTAAT
ACTGTCCAAAGCACGGCAT: CTGTCCAAAGCACGGCATA
GGGTAACGGGGACAGGCAC: GGTAACGGGGACAGGCACG
AGGTTAAATCTAGCAGCAC: GGTTAAATCTAGCAGCACA
CTTTATTGGATTTTCCGTA: TTTATTGGATTTTCCGTAT
GGCATGCATGGCGGGCTTC: GCATGCATGGCGGGCTTCG
AGTGCGCGATGTCAATACG: GTGCGCGATGTCAATACGA
AGTTCGTCTGGCGTATCTC: GTTCGTCTGGCGTATCTCA
GTAACGGGGACAGGCACGT: TAACGGGGACAGGCACGTG
TCCAGTAATACGCAGAAGG: CCAGTAATACGCAGAAGGA
CATTAAGCACCTAGTTGCA: ATTAAGCACCTAGTTGCAA
GTAGTGGCTCAAGCCGAGC: TAGTGGCTCAAGCCGAGCT
CCTTGTCGGAGCTCAAGGT: CTTGTCGGAGCTCAAGGTT
GCTTTGAGGTGATTTTCCG: CTTTGAGGTGATTTTCCGT
CACGTTTAAAAGTATGATA: ACGTTTAAAAGTATGATAT
TCACCGTAGGCAAGGGGCC: CACCGTAGGCAAGGGGCCT
GGTACACGGGGAGCACCCA: GTACACGGGGAGCACCCAA
CGTACAAACTCAACCTGCG: GTACAAACTCAACCTGCGG
AGCACACTTGGAACACAAT: GCACACTTGGAACACAATT
TTTCCGTATTCAAGCGGAT: TTCCGTATTCAAGCGGATG
CTGGTTGTTGTAACGCGAA: TGGTTGTTGTAACGCGAAC
GCGGTTATGAGATCACAAA: CGGTTATGAGATCACAAAC
CTCGCTTAACAGTTCGTCT: TCGCTTAACAGTTCGTCTG
CCCTCGCATTTAGATAGCT: CCTCGCATTTAGATAGCTC
TGTCTACTACCGCCAACCT: GTCTACTACCGCCAACCTG
TTGCAAACTATCCTTAATA: TGCAAACTATCCTTAATAC
CGAGACAGCTTTATATGCC: GAGACAGCTTTATATGCCT
AATTCTGCCCATGGAGGAT: ATTCTGCCCATGGAGGATG
GTAAGTAGTGGCTCAAGCC: TAAGTAGTGGCTCAAGCCG
TTTGAAAAGTGGCATGCAT: TTGAAAAGTGGCATGCATG
GTGGGGGGGGTGCTAGCAC: TGGGGGGGGTGCTAGCACC
GTATTCAAGCCGAATCCCT: TATTCAAGCCGAATCCCTA
AACAGTTCGTCTGGCGTAT: ACAGTTCGTCTGGCGTATC
ATTTTCCGTATTCAAGCGG: TTTTCCGTATTCAAGCGGA
CGTATTCAAGCAACTACTG: GTATTCAAGCAACTACTGT
CCTGCGGAGCTTACCTAGA: CTGCGGAGCTTACCTAGAG
AGGATGATGTCTACTACCG: GGATGATGTCTACTACCGC
TGATCTGCTATCGAAACAC: GATCTGCTATCGAAACACA
GATGTCGACAAAAGCACGG: ATGTCGACAAAAGCACGGC
TGTCGGAGCTCAAGGTTCC: GTCGGAGCTCAAGGTTCCG
GAATCGTAGTGAAACCCAC: AATCGTAGTGAAACCCACC
TCTTTACGCACCTAGGCGT: CTTTACGCACCTAGGCGTT
ACTATCTGAGAAAGAACCG: CTATCTGAGAAAGAACCGA
GGAACCCCCCAACCGGCGG: GAACCCCCCAACCGGCGGT
CGTCCACCTCCTACTGGTT: GTCCACCTCCTACTGGTTG
AGCGGATGTCGACAAAAGC: GCGGATGTCGACAAAAGCA
GGAGTCGAGCAAATTAAAA: GAGTCGAGCAAATTAAAAC
CATAATCTTTACGCACCTA: ATAATCTTTACGCACCTAG
GGATTGGTCGAAGTATACT: GATTGGTCGAAGTATACTT
GGACGGCTACGAATCGTAG: GACGGCTACGAATCGTAGT
CCCACCTCCCATATCCTTG: CCACCTCCCATATCCTTGT
TGGAAGGCTTTCGCATCTC: GGAAGGCTTTCGCATCTCC
AGACAGCTTTATATGCCTG: GACAGCTTTATATGCCTGC
TCGCATCTCCTCACCTCAA: CGCATCTCCTCACCTCAAC
AGCCCGTCAACTTTTCCTG: GCCCGTCAACTTTTCCTGT
ATGTCGACCCCCTTAATTT: TGTCGACCCCCTTAATTTC
GTTTTAATGTCGACCCCCT: TTTTAATGTCGACCCCCTT
GGGGGTCCTACTAACGCGA: GGGGTCCTACTAACGCGAA
CGTTACCTTGTCGGAGCTC: GTTACCTTGTCGGAGCTCA
GAGAAAGAACCGAATCCCC: AGAAAGAACCGAATCCCCT
CTACTGCGCGATTATGGTC: TACTGCGCGATTATGGTCC
CTAAGATTTGATCTGCTAT: TAAGATTTGATCTGCTATC
GAAGGAGAACAGTCTAGTG: AAGGAGAACAGTCTAGTGC
GAGCCCGTCAACTTTTCCT: AGCCCGTCAACTTTTCCTG
GTCTTCTACGGGGGTCCTA: TCTTCTACGGGGGTCCTAC
CCATAGGCCCCTCGCATTT: CATAGGCCCCTCGCATTTA
CACGGCATAATCTTTACGC: ACGGCATAATCTTTACGCA
CTCAACCTGCGGAGCTTAC: TCAACCTGCGGAGCTTACC
TTACCTAGAGCTCGTATAT: TACCTAGAGCTCGTATATA
TGTCCAAAGCACGGCATAA: GTCCAAAGCACGGCATAAT
GGATCCGCCATTCTTAGGT: GATCCGCCATTCTTAGGTC
TTGTGCTTTCCATCACCTG: TGTGCTTTCCATCACCTGT
AACCCCCCAACCGGCGGTG: ACCCCCCAACCGGCGGTGC
GGCCCACAGGTATCGGGAT: GCCCACAGGTATCGGGATC
GCAAACTATCCTTAATACT: CAAACTATCCTTAATACTT
TTGTTCTCTGGCGGCACGT: TGTTCTCTGGCGGCACGTC
TGTTAATCCTGTTGTAAGG: GTTAATCCTGTTGTAAGGC
GGTAGCGCTAGGTTAAATC: GTAGCGCTAGGTTAAATCT
CAATCATCGAGTCAGCCAT: AATCATCGAGTCAGCCATT
TATGAGATCACAAACTGTC: ATGAGATCACAAACTGTCC
TTGACGGAGCATGCGGGGG: TGACGGAGCATGCGGGGGA
CGCCAACCTGCCGGGCCTC: GCCAACCTGCCGGGCCTCT
CGTCCTCTAAAGAGCACAA: GTCCTCTAAAGAGCACAAC
GATTTTCCGTATTCAAGCT: ATTTTCCGTATTCAAGCTG
AGAGAAGCGGAGCCATGGA: GAGAAGCGGAGCCATGGAT
TACCGCCAACCTGCCGGGC: ACCGCCAACCTGCCGGGCC
TGATAACTATCCCTATTTA: GATAACTATCCCTATTTAA
CGCCCTTGCAACTTGTCGT: GCCCTTGCAACTTGTCGTT
TAGAGCGATGTGATAACTA: AGAGCGATGTGATAACTAT
TGGTAGCGCTAGGTTAAAT: GGTAGCGCTAGGTTAAATC
ATTATTGGTTATACGTCTG: TTATTGGTTATACGTCTGT
AGCTTTGAGGTGATTTTCC: GCTTTGAGGTGATTTTCCG
CCGGGCGGGATAGAGTCAG: CGGGCGGGATAGAGTCAGC
TAGCACCACTTCTTACATT: AGCACCACTTCTTACATTG
ATACGCTTGGGTAACGGGG: TACGCTTGGGTAACGGGGA
AGCAACTACTGTCCAAAGC: GCAACTACTGTCCAAAGCA
AATACGCAGAAGGAGAACA: ATACGCAGAAGGAGAACAG
TTAAAGCGCTACAAGTTAA: TAAAGCGCTACAAGTTAAT
CTAGCAACGAATTTAGCAA: TAGCAACGAATTTAGCAAG
ATGCCCGGGCGTGAGAGCC: TGCCCGGGCGTGAGAGCCC
GTAAATACACTTATAAAGT: TAAATACACTTATAAAGTG
CGATTATAGATCCGAGCCT: GATTATAGATCCGAGCCTT
CAACTTTTCCTGTGGGTAC: AACTTTTCCTGTGGGTACA
TTACCACCGGTCTCTGAGG: TACCACCGGTCTCTGAGGG
CCCATGGAGGATGATGTCT: CCATGGAGGATGATGTCTA
TGGAACCCCCCAACCGGCG: GGAACCCCCCAACCGGCGG
ACCTCCCATATCCTTGTCG: CCTCCCATATCCTTGTCGA
TAGGTGGAGTCGAGCAAAT: AGGTGGAGTCGAGCAAATT
GGATCGTCGCTGGACGTGT: GATCGTCGCTGGACGTGTC
CGAAAACTTTACCACCGGT: GAAAACTTTACCACCGGTC
CGCGAAGGGTGAATGGTCT: GCGAAGGGTGAATGGTCTT
CTACGAATCGTAGTGAAAC: TACGAATCGTAGTGAAACC
TCCTTAATACTTGCCAGTC: CCTTAATACTTGCCAGTCA
ACGGACCATTACCATAGGC: CGGACCATTACCATAGGCC
AGAGGGCCCGGCCTGGCTC: GAGGGCCCGGCCTGGCTCT
AAAGCACGGCATAATCTTT: AAGCACGGCATAATCTTTA AAGCACGGCATAATCTTTG AAGCACGGCATAATCTTTT AAGCACGGCATAATCTTTA
TTGAAGTACAGTGACACGG: TGAAGTACAGTGACACGGT
TATACGTCTGTTCCCTCGA: ATACGTCTGTTCCCTCGAT
GTAAGGCGTACCCAAGTTT: TAAGGCGTACCCAAGTTTG
CGGTTATCACGTAAATACA: GGTTATCACGTAAATACAC
GAAACACATTGTGCTTTCC: AAACACATTGTGCTTTCCA
TGCATGGCGGGCTTCGACT: GCATGGCGGGCTTCGACTG
TGTAACGCGAACCTTGAAC: GTAACGCGAACCTTGAACG
CCCTTAATTTCTTTGAAGT: CCTTAATTTCTTTGAAGTA
GCTATCGAAACACATTGTG: CTATCGAAACACATTGTGC
TTACGAAGCAATCATCGAG: TACGAAGCAATCATCGAGT
CTTAATACTTGCCAGTCAC: TTAATACTTGCCAGTCACC
AAAATAACGGGCTGTCGCC: AAATAACGGGCTGTCGCCC
AGAGTCAGCTGGTAGCGCT: GAGTCAGCTGGTAGCGCTA
TAAGCAAATTGGTAATACC: AAGCAAATTGGTAATACCA
CATTACCATAGGCCCCTCG: ATTACCATAGGCCCCTCGC
CGTCAACTTTTCCTGTGGG: GTCAACTTTTCCTGTGGGT
GTATCGGGATCCGCCATTC: TATCGGGATCCGCCATTCT
TGGTCTTCTACGGGGGTCC: GGTCTTCTACGGGGGTCCT
GATATAGAGTTCAAAGTCG: ATATAGAGTTCAAAGTCGC
TTGTTAATCCTGTTGTAAG: TGTTAATCCTGTTGTAAGG
CGAATCCCCTTTATTAAAG: GAATCCCCTTTATTAAAGC
ATAATCTTTTACGCACTCC: TAATCTTTTACGCACTCCG
ACTAATTACCGGGGCTAAC: CTAATTACCGGGGCTAACG
TACTGTCCAAAGCACGGCA: ACTGTCCAAAGCACGGCAT
GCCTGCGGATTCAGGGCAA: CCTGCGGATTCAGGGCAAA
TCAAGGGTGGACGCACGGA: CAAGGGTGGACGCACGGAG
CATCGAGTCAGCCATTCAG: ATCGAGTCAGCCATTCAGC
TTCTTAGGTCCAGTCCAGT: TCTTAGGTCCAGTCCAGTA
TGTCGTTACCTTGTCGGAG: GTCGTTACCTTGTCGGAGC
CTAAGGATTTGAGCATTAT: TAAGGATTTGAGCATTATT
GCGAATTTTCCCTTGATCA: CGAATTTTCCCTTGATCAT
ATGGGACGGCTACGAATCG: TGGGACGGCTACGAATCGT
CTAGTGCGCGATGTCAATA: TAGTGCGCGATGTCAATAC
ATCCGGTTGGAAGGCTTTC: TCCGGTTGGAAGGCTTTCG
AAGTTAATCACAGATTTTC: AGTTAATCACAGATTTTCC
TATGGTCCCCACGTCACGT: ATGGTCCCCACGTCACGTT
AGAGCGATGTGATAACTAT: GAGCGATGTGATAACTATC
CCGTATTCAAGCGGATGTC: CGTATTCAAGCGGATGTCG
TCTTACGGACCATTACCAT: CTTACGGACCATTACCATA
CGACAAAAGCACGGCATAA: GACAAAAGCACGGCATAAT
TCAAAGTCGCGACGGAGAC: CAAAGTCGCGACGGAGACG
AGAACAGTCTAGTGCGCGA: GAACAGTCTAGTGCGCGAT
GAGCTAAGATTTGATCTGC: AGCTAAGATTTGATCTGCT
GCAATCGGATTGGTCGAAG: CAATCGGATTGGTCGAAGT
TGGGGGGGGTGCTAGCACC: GGGGGGGGTGCTAGCACCA
CCCCTCGCATTTAGATAGC: CCCTCGCATTTAGATAGCT
CTACAAGTTAATCGCCGGA: TACAAGTTAATCGCCGGAC
CAAGCCGAATCCCTAAAAA: AAGCCGAATCCCTAAAAAG
CCGGTCTCTGAGGGACTCG: CGGTCTCTGAGGGACTCGC
TGATCCAAACCGCGTACAA: GATCCAAACCGCGTACAAA
AGCAATCATCGAGTCAGCC: GCAATCATCGAGTCAGCCA
TCCTCTAAAGAGCACAACA: CCTCTAAAGAGCACAACAA
TAGTGGCTCAAGCCGAGCT: AGTGGCTCAAGCCGAGCTT
TGCTATGGGACGGCTACGA: GCTATGGGACGGCTACGAA
GCATTTAGATAGCTCCCAC: CATTTAGATAGCTCCCACC
AGATTTGATCTGCTATCGA: GATTTGATCTGCTATCGAA
AATCGGATTGGTCGAAGTA: ATCGGATTGGTCGAAGTAT
GATGTGATAACTATCCCTA: ATGTGATAACTATCCCTAT
CTAATATGTCGTCCACCTC: TAATATGTCGTCCACCTCC
GCGGTTATCACGTAAATAC: CGGTTATCACGTAAATACA
AATTACCGGGGCTAACGTC: ATTACCGGGGCTAACGTCC
TTTAATGTCGACCCCCTTA: TTAATGTCGACCCCCTTAA
TAATTACCGGGGCTAACGT: AATTACCGGGGCTAACGTC
GAAGCAATCATCGAGTCAG: AAGCAATCATCGAGTCAGC
ACAACAACTGTCTCATACG: CAACAACTGTCTCATACGG
CAAAATCGCAATCGGATTG: AAAATCGCAATCGGATTGG
CCGCGTACAAACTCAACCT: CGCGTACAAACTCAACCTG
TCATCCGGTTGGAAGGCTT: CATCCGGTTGGAAGGCTTT
CGCTGGACGTGTCAGGCAT: GCTGGACGTGTCAGGCATC
TATACTTTGACCATCAGCT: ATACTTTGACCATCAGCTA
ATACCAGTTCTAAGGATTT: TACCAGTTCTAAGGATTTG
CTGGCCCACAGGTATCGGG: TGGCCCACAGGTATCGGGA
TAGGCCCCTCGCATTTAGA: AGGCCCCTCGCATTTAGAT
GCAATCATCGAGTCAGCCA: CAATCATCGAGTCAGCCAT
CTCTAAAGAGCACAACAAC: TCTAAAGAGCACAACAACT
CCTGCTATGGGACGGCTAC: CTGCTATGGGACGGCTACG
ACACTGGTATATTTGGTGA: CACTGGTATATTTGGTGAG
AGCTCCCACCTCCCATATC: GCTCCCACCTCCCATATCC
GGCCTCTAAGCAAATTGGT: GCCTCTAAGCAAATTGGTA
TACCATAGGCCCCTCGCAT: ACCATAGGCCCCTCGCATT
CGCGATTATGGTCCCCACG: GCGATTATGGTCCCCACGT
CCTACTAACGCGAAAGCAC: CTACTAACGCGAAAGCACC
GCACGTCGAAAACTTTACC: CACGTCGAAAACTTTACCA
TAAATACACTTATAAAGTG: AAATACACTTATAAAGTGA
GGTTGGAAGGCTTTCGCAT: GTTGGAAGGCTTTCGCATC
CACTTGGAACACAATTCTG: ACTTGGAACACAATTCTGC
CTCGCATTTAGATAGCTCC: TCGCATTTAGATAGCTCCC
CCAAAATCGCAATCGGATT: CAAAATCGCAATCGGATTG
TCTTTATTGGATTTTCCGT: CTTTATTGGATTTTCCGTA
CAGATTTTCCGTATTCAAG: AGATTTTCCGTATTCAAGC
TTTCCGTATTCAAGCTGCC: TTCCGTATTCAAGCTGCCA
TACCTAGAGCTCGTATATA: ACCTAGAGCTCGTATATAG
TACAGTGACACGGTGATCC: ACAGTGACACGGTGATCCA
GGAGCCATCCATCGAGACA: GAGCCATCCATCGAGACAG
CTGCTATCGAAACACATTG: TGCTATCGAAACACATTGT
ATGAGAGTGCTGGCGATTC: TGAGAGTGCTGGCGATTCC
GCTCACTTACATACGCTTG: CTCACTTACATACGCTTGG
CTTGTCGGAGCTCAAGGTT: TTGTCGGAGCTCAAGGTTC
GATTTTCCGTATTCAAGCA: ATTTTCCGTATTCAAGCAA
GGAGCACCCAAGTTAATCA: GAGCACCCAAGTTAATCAC
GTCTAGTGCGCGATGTCAA: TCTAGTGCGCGATGTCAAT
AAGGATTTGAGCATTATTG: AGGATTTGAGCATTATTGG
GGCCCCTCGCATTTAGATA: GCCCCTCGCATTTAGATAG
AAAAGTATGATATAGAGTT: AAAGTATGATATAGAGTTC
CTTAATTTCTTTGAAGTAC: TTAATTTCTTTGAAGTACA
TCAACCTGCGGAGCTTACC: CAACCTGCGGAGCTTACCT
TCAGGGCAAAATAACGGGC: CAGGGCAAAATAACGGGCT
CCTAGCAACGAATTTAGCA: CTAGCAACGAATTTAGCAA
TGTATAGAGCGATGTGATA: GTATAGAGCGATGTGATAA
TACCTTGTCGGAGCTCAAG: ACCTTGTCGGAGCTCAAGG
CAGGTATCGGGATCCGCCA: AGGTATCGGGATCCGCCAT
AGTCCGGTTCTGTGGAACT: GTCCGGTTCTGTGGAACTA
CTTACATACGCTTGGGTAA: TTACATACGCTTGGGTAAC
TACTGCGCGATTATGGTCC: ACTGCGCGATTATGGTCCC
TCCGGTTCTGTGGAACTAA: CCGGTTCTGTGGAACTAAT
GTTATCACGTAAATACACT: TTATCACGTAAATACACTT
AGCTACTAATTACCGGGGC: GCTACTAATTACCGGGGCT
TTGAACGGGCCTCATTAAA: TGAACGGGCCTCATTAAAC
TCATCGAGTCAGCCATTCA: CATCGAGTCAGCCATTCAG
GTACAAACTCAACCTGCGG: TACAAACTCAACCTGCGGA
CAGAAGGAGAACAGTCTAG: AGAAGGAGAACAGTCTAGT
GTCCAGTCCAGTAATACGC: TCCAGTCCAGTAATACGCA
GGGCCTCATTAAACATGGT: GGCCTCATTAAACATGGTC
GGGTACACGGGGAGCACCC: GGTACACGGGGAGCACCCA
ATAATCTTTACGCACCTAG: TAATCTTTACGCACCTAGG
GACGCGAGCTAAGATTTGA: ACGCGAGCTAAGATTTGAT
GTGAGAGCCCGTCAACTTT: TGAGAGCCCGTCAACTTTT
AACTGGTTCAAGGGTGGAC: ACTGGTTCAAGGGTGGACG
GTCCTACTAACGCGAAAGC: TCCTACTAACGCGAAAGCA
TATAAAGTGAGTGCGTTGT: ATAAAGTGAGTGCGTTGTT
CTCACTTACATACGCTTGG: TCACTTACATACGCTTGGG
GAGACAGCTTTATATGCCT: AGACAGCTTTATATGCCTG
TCCGGTTGGAAGGCTTTCG: CCGGTTGGAAGGCTTTCGC
TTTGACGGAGCATGCGGGG: TTGACGGAGCATGCGGGGG
CTACTGTCCAAAGCACGGC: TACTGTCCAAAGCACGGCA
TGAACGGGCCTCATTAAAC: GAACGGGCCTCATTAAACA
TACGGGGGTCCTACTAACG: ACGGGGGTCCTACTAACGC
CTCAAGGTTCCGGGCGGGA: TCAAGGTTCCGGGCGGGAT
TTCAAGCTGCCAAGTGGAA: TCAAGCTGCCAAGTGGAAA
AGCGCTACAAGTTAATCGC: GCGCTACAAGTTAATCGCC
GGTAATACCAGTTCTAAGG: GTAATACCAGTTCTAAGGA
ACCTCAGTTCCCCAAAATC: CCTCAGTTCCCCAAAATCG
CCATTACCATAGGCCCCTC: CATTACCATAGGCCCCTCG
ACTTACATACGCTTGGGTA: CTTACATACGCTTGGGTAA
CGCTCCGTCCGGGACAAGA: GCTCCGTCCGGGACAAGAG
ATTAAACATGGTCCGGATC: TTAAACATGGTCCGGATCG
GATCTGTATAGAGCGATGT: ATCTGTATAGAGCGATGTG
GATTTTCCGTATTCAAGCC: ATTTTCCGTATTCAAGCCG
CATAATCTTTATTGGATTT: ATAATCTTTATTGGATTTT
AACGCATGGACTGATCTGT: ACGCATGGACTGATCTGTA
GCAACTTGTCGTTACCTTG: CAACTTGTCGTTACCTTGT
GGGCCCGGCCTGGCTCTTT: GGCCCGGCCTGGCTCTTTG
CACCTCAACGTCCTCTAAA: ACCTCAACGTCCTCTAAAG
CTCCGTCCGGGACAAGAGA: TCCGTCCGGGACAAGAGAA
TTAGCAAGCGAATTTTCCC: TAGCAAGCGAATTTTCCCT
ATGAGATCACAAACTGTCC: TGAGATCACAAACTGTCCC
GGGACAGGCACGTGGGGGG: GGACAGGCACGTGGGGGGG
TTCAGCTTTGAGGTGATTT: TCAGCTTTGAGGTGATTTT
CAACCGGCGGTGCATGACT: AACCGGCGGTGCATGACTG
CGATTTTCCGTATTCAAGC: GATTTTCCGTATTCAAGCC
GTCCGGGACAAGAGAAGCG: TCCGGGACAAGAGAAGCGG
CTGTTGTAAGGCGTACCCA: TGTTGTAAGGCGTACCCAA
CGTCCCCTAGCAACGAATT: GTCCCCTAGCAACGAATTT
TCAGCCATTCAGCTTTGAG: CAGCCATTCAGCTTTGAGG
CGGCGGTGCATGACTGATA: GGCGGTGCATGACTGATAG
AATCTAGCAGCACACTTGG: ATCTAGCAGCACACTTGGA
TAAAAGTATGATATAGAGT: AAAAGTATGATATAGAGTT
TCATTAAACATGGTCCGGA: CATTAAACATGGTCCGGAT
CCAGTCCAGTAATACGCAG: CAGTCCAGTAATACGCAGA
ATCTTTTACGCACTCCGGA: TCTTTTACGCACTCCGGAG
ACGTGGGGGGGGTGCTAGC: CGTGGGGGGGGTGCTAGCA
TGAGACAACGCATGGACTG: GAGACAACGCATGGACTGA
ATATCCTTGTCGATTTTCC: TATCCTTGTCGATTTTCCG
CAGTAATACGCAGAAGGAG: AGTAATACGCAGAAGGAGA
ACTGCGCGATTATGGTCCC: CTGCGCGATTATGGTCCCC
ATAAAGTGAGTGCGTTGTT: TAAAGTGAGTGCGTTGTTA
CCCTTGATCATGCGTGCCA: CCTTGATCATGCGTGCCAC
TCAAGCCGAATCCCTAAAA: CAAGCCGAATCCCTAAAAA
TAGAGTCAGCTGGTAGCGC: AGAGTCAGCTGGTAGCGCT
TTAAACATGGTCCGGATCG: TAAACATGGTCCGGATCGT
TCCATCACCTGTTAGGTGG: CCATCACCTGTTAGGTGGA
TGGTGAGTGTCATCCGGTT: GGTGAGTGTCATCCGGTTG
AGTAAGTAGTGGCTCAAGC: GTAAGTAGTGGCTCAAGCC
AGGCATCCGGTAGGCAGTC: GGCATCCGGTAGGCAGTCC
GGAGCATGCGGGGGACGCG: GAGCATGCGGGGGACGCGA
GGTATATTTGGTGAGTGTC: GTATATTTGGTGAGTGTCA
AAATCGCAATCGGATTGGT: AATCGCAATCGGATTGGTC
CGGCATAATCTTTGACGGA: GGCATAATCTTTGACGGAG
ACATTGGAACCCCCCAACC: CATTGGAACCCCCCAACCG
TTCTAAGGATTTGAGCATT: TCTAAGGATTTGAGCATTA
GTCTCTGAGGGACTCGCTT: TCTCTGAGGGACTCGCTTA
CCGCCAACCTGCCGGGCCT: CGCCAACCTGCCGGGCCTC
GCTTAACAGTTCGTCTGGC: CTTAACAGTTCGTCTGGCG
GTTCTAAGGATTTGAGCAT: TTCTAAGGATTTGAGCATT
AAAGCACCTGGCCCACAGG: AAGCACCTGGCCCACAGGT
TCGTATATAGACCGGTCTT: CGTATATAGACCGGTCTTT
ACACAATTCTGCCCATGGA: CACAATTCTGCCCATGGAG
TACGTCTGTTCCCTCGATT: ACGTCTGTTCCCTCGATTA
GGGGGGGGTGCTAGCACCA: GGGGGGGTGCTAGCACCAC
AGGCGTACCCAAGTTTGAA: GGCGTACCCAAGTTTGAAA
GTGCTAGCACCACTTCTTA: TGCTAGCACCACTTCTTAC
TTCCCTTGATCATGCGTGC: TCCCTTGATCATGCGTGCC
TTTGGTGAGTGTCATCCGG: TTGGTGAGTGTCATCCGGT
CGGGGCTAACGTCCCCTAG: GGGGCTAACGTCCCCTAGC
GAGGTGATTTTCCGTATTC: AGGTGATTTTCCGTATTCA
ACAAAAGCACGGCATAATC: CAAAAGCACGGCATAATCT
TCGCCCTTGCAACTTGTCG: CGCCCTTGCAACTTGTCGT
TAGAGGGCCCGGCCTGGCT: AGAGGGCCCGGCCTGGCTC
CTATCCCTATTTAAGGCGG: TATCCCTATTTAAGGCGGT
TCGAGTCAGCCATTCAGCT: CGAGTCAGCCATTCAGCTT
TTAGGTGGAGTCGAGCAAA: TAGGTGGAGTCGAGCAAAT
TGAAGTACAGTGACACGGT: GAAGTACAGTGACACGGTG
TTTTCCGTATTCAAGCCGA: TTTCCGTATTCAAGCCGAA
ATCCTTAATACTTGCCAGT: TCCTTAATACTTGCCAGTC
ATTCAAGCTGCCAAGTGGA: TTCAAGCTGCCAAGTGGAA
TAAACATGGTCCGGATCGT: AAACATGGTCCGGATCGTC
TTGAGCATTATTGGTTATA: TGAGCATTATTGGTTATAC
CTGTTCCCTCGATTATAGA: TGTTCCCTCGATTATAGAT
GGACGCGAGCTAAGATTTG: GACGCGAGCTAAGATTTGA
GTCTCATACGGGGTCATTT: TCTCATACGGGGTCATTTA
TGTGATAACTATCCCTATT: GTGATAACTATCCCTATTT
TAAATCTAGCAGCACACTT: AAATCTAGCAGCACACTTG
TTGGTCGAAGTATACTTTG: TGGTCGAAGTATACTTTGA
TGCCAGTCACCGTAGGCAA: GCCAGTCACCGTAGGCAAG
TAAGATTTGATCTGCTATC: AAGATTTGATCTGCTATCG
GCTTTCCATCACCTGTTAG: CTTTCCATCACCTGTTAGG
TCCGTATTCAAGCAACTAC: CCGTATTCAAGCAACTACT
GCTGGTAGCGCTAGGTTAA: CTGGTAGCGCTAGGTTAAA
AAAGTGGCATGCATGGCGG: AAGTGGCATGCATGGCGGG
CTGATCTGTATAGAGCGAT: TGATCTGTATAGAGCGATG
CGTATTCAAGCCGAATCCC: GTATTCAAGCCGAATCCCT
TAAAGCGCTACAAGTTAAT: AAAGCGCTACAAGTTAATC
CAAGTGGAAAAGCACGGCA: AAGTGGAAAAGCACGGCAT
GTTATACGTCTGTTCCCTC: TTATACGTCTGTTCCCTCG
ACGTCGAAAACTTTACCAC: CGTCGAAAACTTTACCACC
GCCATTCAGCTTTGAGGTG: CCATTCAGCTTTGAGGTGA
TGCGGGCGGTTATCACGTA: GCGGGCGGTTATCACGTAA
ATTCAAGCCGAATCCCTAA: TTCAAGCCGAATCCCTAAA
GGCAGTCCCTTGCGGGCGG: GCAGTCCCTTGCGGGCGGT
CGCAGAAGGAGAACAGTCT: GCAGAAGGAGAACAGTCTA
CAGCTTTGAGGTGATTTTC: AGCTTTGAGGTGATTTTCC
CGCACCTAGGCGTTGGAGT: GCACCTAGGCGTTGGAGTG
GTATAGAGCGATGTGATAA: TATAGAGCGATGTGATAAC
CGCGACGGAGACGGAGGAA: GCGACGGAGACGGAGGAAG
TTTTGTTCTCTGGCGGCAC: TTTGTTCTCTGGCGGCACG
GGTTTTGTTCTCTGGCGGC: GTTTTGTTCTCTGGCGGCA
CTTGTCGATTTTCCGTATT: TTGTCGATTTTCCGTATTC
CGAAGGGTGAATGGTCTTC: GAAGGGTGAATGGTCTTCT
ACAATTCTGCCCATGGAGG: CAATTCTGCCCATGGAGGA
GGAAAAGCACGGCATAATC: GAAAAGCACGGCATAATCT
ATCCATCGAGACAGCTTTA: TCCATCGAGACAGCTTTAT
AACGGGGACAGGCACGTGG: ACGGGGACAGGCACGTGGG
TGGGTACACGGGGAGCACC: GGGTACACGGGGAGCACCC
GCACTCCGGAGCCATCCAT: CACTCCGGAGCCATCCATC
TAGTCCGGTTCTGTGGAAC: AGTCCGGTTCTGTGGAACT
GGGGTGCTAGCACCACTTC: GGGTGCTAGCACCACTTCT
CTGTGGAACTAATATGTCG: TGTGGAACTAATATGTCGT
TATCTGAGAAAGAACCGAA: ATCTGAGAAAGAACCGAAT
GAATGAGAGTGCTGGCGAT: AATGAGAGTGCTGGCGATT
ATTCTGCCCATGGAGGATG: TTCTGCCCATGGAGGATGA
GTCGAAGTATACTTTGACC: TCGAAGTATACTTTGACCA
ATGTCGACAAAAGCACGGC: TGTCGACAAAAGCACGGCA
AACTATCCTTAATACTTGC: ACTATCCTTAATACTTGCC
CTTGTTTCCTGCTATGGGA: TTGTTTCCTGCTATGGGAC
CCGGTTCTGTGGAACTAAT: CGGTTCTGTGGAACTAATA
GTCGAGCAAATTAAAACAC: TCGAGCAAATTAAAACACT
GGGACTCGCTTAACAGTTC: GGACTCGCTTAACAGTTCG
AAATTGGTAATACCAGTTC: AATTGGTAATACCAGTTCT
AAGAGCACAACAACTGTCT: AGAGCACAACAACTGTCTC
GGTCCAGTCCAGTAATACG: GTCCAGTCCAGTAATACGC
TAACGTCCCCTAGCAACGA: AACGTCCCCTAGCAACGAA
GAGGATGATGTCTACTACC: AGGATGATGTCTACTACCG
TGCGTGCCACTCAATGTAG: GCGTGCCACTCAATGTAGG
TTTTTGTGTGACTATCTGA: TTTTGTGTGACTATCTGAG
GGGCGGGATAGAGTCAGCT: GGCGGGATAGAGTCAGCTG
GCTCAAGGTTCCGGGCGGG: CTCAAGGTTCCGGGCGGGA
TATAGATCCGAGCCTTTAC: ATAGATCCGAGCCTTTACA
AAGCACGGCATAATCTTTA: AGCACGGCATAATCTTTAT AGCACGGCATAATCTTTAC
CTGTCTCATACGGGGTCAT: TGTCTCATACGGGGTCATT
GCGGGCTTCGACTGTTTTC: CGGGCTTCGACTGTTTTCG
CAACGTCCTCTAAAGAGCA: AACGTCCTCTAAAGAGCAC
CTTAACAGTTCGTCTGGCG: TTAACAGTTCGTCTGGCGT
CGGGGAGCACCCAAGTTAA: GGGGAGCACCCAAGTTAAT
AATTTTCCCTTGATCATGC: ATTTTCCCTTGATCATGCG
GGCGGTGCATGACTGATAG: GCGGTGCATGACTGATAGA
TGAGAGCCCGTCAACTTTT: GAGAGCCCGTCAACTTTTC
CTTACCTAGAGCTCGTATA: TTACCTAGAGCTCGTATAT
CGAGCTTCATACCAGGCCG: GAGCTTCATACCAGGCCGT
TCTGCTATCGAAACACATT: CTGCTATCGAAACACATTG
ATAGAGTTCAAAGTCGCGA: TAGAGTTCAAAGTCGCGAC
TTCGCTCCGTCCGGGACAA: TCGCTCCGTCCGGGACAAG
AAGCGCTACAAGTTAATCG: AGCGCTACAAGTTAATCGC
AGCAATTTCAGCTCACTTA: GCAATTTCAGCTCACTTAC
AAGCCGAGCTTCATACCAG: AGCCGAGCTTCATACCAGG
ATTCAAGCGGATGTCGACA: TTCAAGCGGATGTCGACAA
GGCTCAAGCCGAGCTTCAT: GCTCAAGCCGAGCTTCATA
AATCCCCTTTATTAAAGCG: ATCCCCTTTATTAAAGCGC
ACAAACTCAACCTGCGGAG: CAAACTCAACCTGCGGAGC
ACATTGTGCTTTCCATCAC: CATTGTGCTTTCCATCACC
GCACAACAACTGTCTCATA: CACAACAACTGTCTCATAC
AAAGTATGATATAGAGTTC: AAGTATGATATAGAGTTCA
TAGTTGCAAACTATCCTTA: AGTTGCAAACTATCCTTAA
GCTAAGATTTGATCTGCTA: CTAAGATTTGATCTGCTAT
AACCGAATCCCCTTTATTA: ACCGAATCCCCTTTATTAA
GCTACAAGTTAATCGCCGG: CTACAAGTTAATCGCCGGA
AGCCGAGCTTCATACCAGG: GCCGAGCTTCATACCAGGC
TAAGGATTTGAGCATTATT: AAGGATTTGAGCATTATTG
AACCGGCGGTGCATGACTG: ACCGGCGGTGCATGACTGA
TCGAAGTATACTTTGACCA: CGAAGTATACTTTGACCAT
GCTGGCGATTCCCAACTGG: CTGGCGATTCCCAACTGGT
CGGTCTCTGAGGGACTCGC: GGTCTCTGAGGGACTCGCT
CACGTGGGGGGGGTGCTAG: ACGTGGGGGGGGTGCTAGC
AGAAGCGGAGCCATGGATT: GAAGCGGAGCCATGGATTC
GCCAAGTGGAAAAGCACGG: CCAAGTGGAAAAGCACGGC
AGAAGGAGAACAGTCTAGT: GAAGGAGAACAGTCTAGTG
CGATTATGGTCCCCACGTC: GATTATGGTCCCCACGTCA
TATGGGACGGCTACGAATC: ATGGGACGGCTACGAATCG
TCGTCCACCTCCTACTGGT: CGTCCACCTCCTACTGGTT
AGTACAGTGACACGGTGAT: GTACAGTGACACGGTGATC
GTGGGTACACGGGGAGCAC: TGGGTACACGGGGAGCACC
GTAACGCGAACCTTGAACG: TAACGCGAACCTTGAACGG
CACTCCGGAGCCATCCATC: ACTCCGGAGCCATCCATCG
GTCTTTTTGTGTGACTATC: TCTTTTTGTGTGACTATCT
TTCCCAACTGGTTCAAGGG: TCCCAACTGGTTCAAGGGT
ACGGAGACGGAGGAAGCAA: CGGAGACGGAGGAAGCAAT
ACTAATATGTCGTCCACCT: CTAATATGTCGTCCACCTC
ACGCTTGGGTAACGGGGAC: CGCTTGGGTAACGGGGACA
AGCACCTAGTTGCAAACTA: GCACCTAGTTGCAAACTAT
TTTTCCCTTGATCATGCGT: TTTCCCTTGATCATGCGTG
AGACAACGCATGGACTGAT: GACAACGCATGGACTGATC
TTAAGCACCTAGTTGCAAA: TAAGCACCTAGTTGCAAAC
CCCATTAAGCACCTAGTTG: CCATTAAGCACCTAGTTGC
TTCAAAGTCGCGACGGAGA: TCAAAGTCGCGACGGAGAC
GTGAGTGTCATCCGGTTGG: TGAGTGTCATCCGGTTGGA
GTTCCCTCGATTATAGATC: TTCCCTCGATTATAGATCC
GACTGTTTTCGCTCCGTCC: ACTGTTTTCGCTCCGTCCG
CTGCGGAGCTTACCTAGAG: TGCGGAGCTTACCTAGAGC
CACACTTGGAACACAATTC: ACACTTGGAACACAATTCT
CGACCCCCTTAATTTCTTT: GACCCCCTTAATTTCTTTG
GAGGGACTCGCTTAACAGT: AGGGACTCGCTTAACAGTT
TTTAGCAAGCGAATTTTCC: TTAGCAAGCGAATTTTCCC
CCATGGAGGATGATGTCTA: CATGGAGGATGATGTCTAC
TGTTGTAAGGCGTACCCAA: GTTGTAAGGCGTACCCAAG
AACTTTACCACCGGTCTCT: ACTTTACCACCGGTCTCTG
AAACTCAACCTGCGGAGCT: AACTCAACCTGCGGAGCTT
TCGCAATCGGATTGGTCGA: CGCAATCGGATTGGTCGAA
CCCCAAAATCGCAATCGGA: CCCAAAATCGCAATCGGAT
TCCCACCTCCCATATCCTT: CCCACCTCCCATATCCTTG
AGTCCAGTAATACGCAGAA: GTCCAGTAATACGCAGAAG
AGCCATTCAGCTTTGAGGT: GCCATTCAGCTTTGAGGTG
AATTAAAACACTGGTATAT: ATTAAAACACTGGTATATT
AGCGATGTGATAACTATCC: GCGATGTGATAACTATCCC
TAGAGCTCGTATATAGACC: AGAGCTCGTATATAGACCG
ATTTTCCCTTGATCATGCG: TTTTCCCTTGATCATGCGT
GCACCACTTCTTACATTGG: CACCACTTCTTACATTGGA
CAACCTGCCGGGCCTCTAA: AACCTGCCGGGCCTCTAAG
AGATCACAAACTGTCCCCA: GATCACAAACTGTCCCCAT
CCCTTGCAACTTGTCGTTA: CCTTGCAACTTGTCGTTAC
ACCTGGCCCACAGGTATCG: CCTGGCCCACAGGTATCGG
GTGTCATCCGGTTGGAAGG: TGTCATCCGGTTGGAAGGC
GGGGACAGGCACGTGGGGG: GGGACAGGCACGTGGGGGG
TCCCTATTTAAGGCGGTTA: CCCTATTTAAGGCGGTTAT
ACTGTCTCATACGGGGTCA: CTGTCTCATACGGGGTCAT
ACGCATGGACTGATCTGTA: CGCATGGACTGATCTGTAT
TTAAATCTAGCAGCACACT: TAAATCTAGCAGCACACTT
CCCCCTTAATTTCTTTGAA: CCCCTTAATTTCTTTGAAG
TGGATTCTTGTTTCCTGCT: GGATTCTTGTTTCCTGCTA
GGTTGTTGTAACGCGAACC: GTTGTTGTAACGCGAACCT
GTGGCTCAAGCCGAGCTTC: TGGCTCAAGCCGAGCTTCA
CACGGGGAGCACCCAAGTT: ACGGGGAGCACCCAAGTTA
TGTGGAACTAATATGTCGT: GTGGAACTAATATGTCGTC
CGATTCCCAACTGGTTCAA: GATTCCCAACTGGTTCAAG
GATAGGCATATGCCCGGGC: ATAGGCATATGCCCGGGCG
AGCACCACTTCTTACATTG: GCACCACTTCTTACATTGG
TCTAGCAGCACACTTGGAA: CTAGCAGCACACTTGGAAC
GAATCCCTAAAAAGCACGG: AATCCCTAAAAAGCACGGC
CCGGAGCCATCCATCGAGA: CGGAGCCATCCATCGAGAC
AGAGCACAACAACTGTCTC: GAGCACAACAACTGTCTCA
TGTCGTCCACCTCCTACTG: GTCGTCCACCTCCTACTGG
CAGTCACCGTAGGCAAGGG: AGTCACCGTAGGCAAGGGG
GTTAATCGCCGGACGCGAG: TTAATCGCCGGACGCGAGC
AATCATCGAGTCAGCCATT: ATCATCGAGTCAGCCATTC
CCTGCCGGGCCTCTAAGCA: CTGCCGGGCCTCTAAGCAA
ATAGGCCCCTCGCATTTAG: TAGGCCCCTCGCATTTAGA
TAAGTAGTGGCTCAAGCCG: AAGTAGTGGCTCAAGCCGA
AAGGCGGTTATGAGATCAC: AGGCGGTTATGAGATCACA
ATGATGTCTACTACCGCCA: TGATGTCTACTACCGCCAA
GTCGCCCTTGCAACTTGTC: TCGCCCTTGCAACTTGTCG
TGGGACGGCTACGAATCGT: GGGACGGCTACGAATCGTA
AGTGAGTGCGTTGTTAATC: GTGAGTGCGTTGTTAATCC
GCTAGCACCACTTCTTACA: CTAGCACCACTTCTTACAT
TAGGTTAAATCTAGCAGCA: AGGTTAAATCTAGCAGCAC
CAAGGTTCCGGGCGGGATA: AAGGTTCCGGGCGGGATAG
CGGTTGGAAGGCTTTCGCA: GGTTGGAAGGCTTTCGCAT
TAAAGAGCACAACAACTGT: AAAGAGCACAACAACTGTC
GGGCTAACGTCCCCTAGCA: GGCTAACGTCCCCTAGCAA
GATCATGCGTGCCACTCAA: ATCATGCGTGCCACTCAAT
GAATTTAGCAAGCGAATTT: AATTTAGCAAGCGAATTTT
AGCTCACTTACATACGCTT: GCTCACTTACATACGCTTG
GCAAATTGGTAATACCAGT: CAAATTGGTAATACCAGTT
GTATCTCAATGTGCCTACT: TATCTCAATGTGCCTACTG
ACGTCCCCTAGCAACGAAT: CGTCCCCTAGCAACGAATT
TATGATATAGAGTTCAAAG: ATGATATAGAGTTCAAAGT
GAATCCCCTTTATTAAAGC: AATCCCCTTTATTAAAGCG
TGCCGGGCCTCTAAGCAAA: GCCGGGCCTCTAAGCAAAT
TTTCCTGCTATGGGACGGC: TTCCTGCTATGGGACGGCT
CGGAGACGGAGGAAGCAAT: GGAGACGGAGGAAGCAATT
AGTTTGAAAAGTGGCATGC: GTTTGAAAAGTGGCATGCA
CTGCCAAGTGGAAAAGCAC: TGCCAAGTGGAAAAGCACG
GTGCATGACTGATAGAGGG: TGCATGACTGATAGAGGGC
ACCGCGTACAAACTCAACC: CCGCGTACAAACTCAACCT
CCCTTGCGGGCGGTTATCA: CCTTGCGGGCGGTTATCAC
TGCTAGCACCACTTCTTAC: GCTAGCACCACTTCTTACA
ACGGGCTGTCGCCCTTGCA: CGGGCTGTCGCCCTTGCAA
GCACGGCATAATCTTTACG: CACGGCATAATCTTTACGC
GACCATTACCATAGGCCCC: ACCATTACCATAGGCCCCT
AATCTTTGACGGAGCATGC: ATCTTTGACGGAGCATGCG
CAGCCATTCAGCTTTGAGG: AGCCATTCAGCTTTGAGGT
CTATGGGACGGCTACGAAT: TATGGGACGGCTACGAATC
TTTCGCTCCGTCCGGGACA: TTCGCTCCGTCCGGGACAA
ATCTCAATGTGCCTACTGC: TCTCAATGTGCCTACTGCG
AAAGTCGCGACGGAGACGG: AAGTCGCGACGGAGACGGA
TGGACGCACGGAGTAAGTA: GGACGCACGGAGTAAGTAG
TTGTAAGGCGTACCCAAGT: TGTAAGGCGTACCCAAGTT
GTATTCAAGCTGCCAAGTG: TATTCAAGCTGCCAAGTGG
TAACAGTTCGTCTGGCGTA: AACAGTTCGTCTGGCGTAT
GCAGAAGGAGAACAGTCTA: CAGAAGGAGAACAGTCTAG
TTGTCGTTACCTTGTCGGA: TGTCGTTACCTTGTCGGAG
TGCGCGATTATGGTCCCCA: GCGCGATTATGGTCCCCAC
GATTATGGTCCCCACGTCA: ATTATGGTCCCCACGTCAC
TTTGAGGTGATTTTCCGTA: TTGAGGTGATTTTCCGTAT
ACCGGGGCTAACGTCCCCT: CCGGGGCTAACGTCCCCTA
CCTCGCATTTAGATAGCTC: CTCGCATTTAGATAGCTCC
GCCTCTAAGCAAATTGGTA: CCTCTAAGCAAATTGGTAA
ATTTTCCGTATTCAAGCTG: TTTTCCGTATTCAAGCTGC
AAAGCGCTACAAGTTAATC: AAGCGCTACAAGTTAATCG
ACCTGTTAGGTGGAGTCGA: CCTGTTAGGTGGAGTCGAG
TTGGTGAGTGTCATCCGGT: TGGTGAGTGTCATCCGGTT
GTGGAAAAGCACGGCATAA: TGGAAAAGCACGGCATAAT
TAGCGCTAGGTTAAATCTA: AGCGCTAGGTTAAATCTAG
AGTCACCGTAGGCAAGGGG: GTCACCGTAGGCAAGGGGC
TCTGTTCCCTCGATTATAG: CTGTTCCCTCGATTATAGA
GAAGTATACTTTGACCATC: AAGTATACTTTGACCATCA
GAGCACAACAACTGTCTCA: AGCACAACAACTGTCTCAT
AGAGCCCGTCAACTTTTCC: GAGCCCGTCAACTTTTCCT
AGGCTTTCGCATCTCCTCA: GGCTTTCGCATCTCCTCAC
ACGGAGTAAGTAGTGGCTC: CGGAGTAAGTAGTGGCTCA
ATGCATGGCGGGCTTCGAC: TGCATGGCGGGCTTCGACT
TCTTTTACGCACTCCGGAG: CTTTTACGCACTCCGGAGC
TCAGCTACTAATTACCGGG: CAGCTACTAATTACCGGGG
TGACTGATAGAGGGCCCGG: GACTGATAGAGGGCCCGGC
GGCTTCGACTGTTTTCGCT: GCTTCGACTGTTTTCGCTC
AGCCATGGATTCTTGTTTC: GCCATGGATTCTTGTTTCC
AGTATGATATAGAGTTCAA: GTATGATATAGAGTTCAAA
TACTAACGCGAAAGCACCT: ACTAACGCGAAAGCACCTG
AGCACGGCATAATCTTTTA: GCACGGCATAATCTTTTAC
TCACAAACTGTCCCCATTA: CACAAACTGTCCCCATTAA
ATTACCATAGGCCCCTCGC: TTACCATAGGCCCCTCGCA
AAACATGGTCCGGATCGTC: AACATGGTCCGGATCGTCG
ACCGGTCTCTGAGGGACTC: CCGGTCTCTGAGGGACTCG
TATAGACCGGTCTTTTTGT: ATAGACCGGTCTTTTTGTG
CCAAAGCACGGCATAATCT: CAAAGCACGGCATAATCTT
GTTAATCACAGATTTTCCG: TTAATCACAGATTTTCCGT
GCGCGATTATGGTCCCCAC: CGCGATTATGGTCCCCACG
CGCACTCCGGAGCCATCCA: GCACTCCGGAGCCATCCAT
TCCCAACTGGTTCAAGGGT: CCCAACTGGTTCAAGGGTG
TTCAAGCAACTACTGTCCA: TCAAGCAACTACTGTCCAA
CATCACCTGTTAGGTGGAG: ATCACCTGTTAGGTGGAGT
TTTATTAAAGCGCTACAAG: TTATTAAAGCGCTACAAGT
AGCAAATTGGTAATACCAG: GCAAATTGGTAATACCAGT
GATCCGAGCCTTTACAGGG: ATCCGAGCCTTTACAGGGT
CACCACTTCTTACATTGGA: ACCACTTCTTACATTGGAA
GGTCCGGATCGTCGCTGGA: GTCCGGATCGTCGCTGGAC
CATTCTTAGGTCCAGTCCA: ATTCTTAGGTCCAGTCCAG
AACTACTGTCCAAAGCACG: ACTACTGTCCAAAGCACGG
TTTCGCATCTCCTCACCTC: TTCGCATCTCCTCACCTCA
AAGTGAGTGCGTTGTTAAT: AGTGAGTGCGTTGTTAATC
TGCCTGCGGATTCAGGGCA: GCCTGCGGATTCAGGGCAA
CTGTATAGAGCGATGTGAT: TGTATAGAGCGATGTGATA
GAGCTCAAGGTTCCGGGCG: AGCTCAAGGTTCCGGGCGG
GGCGGGATAGAGTCAGCTG: GCGGGATAGAGTCAGCTGG
CCAAGTGGAAAAGCACGGC: CAAGTGGAAAAGCACGGCA
CTCTGAGGGACTCGCTTAA: TCTGAGGGACTCGCTTAAC
CCGGTCTTTTTGTGTGACT: CGGTCTTTTTGTGTGACTA
CTTTACGCACCTAGGCGTT: TTTACGCACCTAGGCGTTG
CTTTGACCATCAGCTACTA: TTTGACCATCAGCTACTAA
AGTGAAACCCACCTCAGTT: GTGAAACCCACCTCAGTTC
GTCGACAAAAGCACGGCAT: TCGACAAAAGCACGGCATA
CGGTCTTTTTGTGTGACTA: GGTCTTTTTGTGTGACTAT
TGCGGAGCTTACCTAGAGC: GCGGAGCTTACCTAGAGCT
GGCGTATCTCAATGTGCCT: GCGTATCTCAATGTGCCTA
GATGATGTCTACTACCGCC: ATGATGTCTACTACCGCCA
CCCGTCAACTTTTCCTGTG: CCGTCAACTTTTCCTGTGG
AGTCAGCCATTCAGCTTTG: GTCAGCCATTCAGCTTTGA
CCTCCTACTGGTTGTTGTA: CTCCTACTGGTTGTTGTAA
GAAAGCACCTGGCCCACAG: AAAGCACCTGGCCCACAGG
TGCGTTGTTAATCCTGTTG: GCGTTGTTAATCCTGTTGT
GTGAGTGCGTTGTTAATCC: TGAGTGCGTTGTTAATCCT
GACTGATCTGTATAGAGCG: ACTGATCTGTATAGAGCGA
CCATATCCTTGTCGATTTT: CATATCCTTGTCGATTTTC
ACCGGTCTTTTTGTGTGAC: CCGGTCTTTTTGTGTGACT
TCTGAGGGACTCGCTTAAC: CTGAGGGACTCGCTTAACA
CCTAGTTGCAAACTATCCT: CTAGTTGCAAACTATCCTT
AAGTATACTTTGACCATCA: AGTATACTTTGACCATCAG
CTAAGCAAATTGGTAATAC: TAAGCAAATTGGTAATACC
GCTACTAATTACCGGGGCT: CTACTAATTACCGGGGCTA
GCAAAATAACGGGCTGTCG: CAAAATAACGGGCTGTCGC
AAACACATTGTGCTTTCCA: AACACATTGTGCTTTCCAT
TCAAGGTTCCGGGCGGGAT: CAAGGTTCCGGGCGGGATA
ATTTACGAAGCAATCATCG: TTTACGAAGCAATCATCGA
TTGACCATCAGCTACTAAT: TGACCATCAGCTACTAATT
AGCCATCCATCGAGACAGC: GCCATCCATCGAGACAGCT
ACAACTGTCTCATACGGGG: CAACTGTCTCATACGGGGT
ATGGTCCCCACGTCACGTT: TGGTCCCCACGTCACGTTT
GGGCCTCTAAGCAAATTGG: GGCCTCTAAGCAAATTGGT
ATCTCCTCACCTCAACGTC: TCTCCTCACCTCAACGTCC
CTGCCCATGGAGGATGATG: TGCCCATGGAGGATGATGT
GCGTATCTCAATGTGCCTA: CGTATCTCAATGTGCCTAC
ATTTTCCGTATTCAAGCAA: TTTTCCGTATTCAAGCAAC
GGGTTTTGTTCTCTGGCGG: GGTTTTGTTCTCTGGCGGC
GGCATAATCTTTACGCACC: GCATAATCTTTACGCACCT
TGTTTCCTGCTATGGGACG: GTTTCCTGCTATGGGACGG
CAATTTCAGCTCACTTACA: AATTTCAGCTCACTTACAT
CCCAACTGGTTCAAGGGTG: CCAACTGGTTCAAGGGTGG
CTCAGTTCCCCAAAATCGC: TCAGTTCCCCAAAATCGCA
CACCTCCCATATCCTTGTC: ACCTCCCATATCCTTGTCG
ACCCAAGTTAATCACAGAT: CCCAAGTTAATCACAGATT
CTTGCCAGTCACCGTAGGC: TTGCCAGTCACCGTAGGCA
GATCGTCGCTGGACGTGTC: ATCGTCGCTGGACGTGTCA
TTCGTCTGGCGTATCTCAA: TCGTCTGGCGTATCTCAAT
GCCGGACGCGAGCTAAGAT: CCGGACGCGAGCTAAGATT
GTGAATGGTCTTCTACGGG: TGAATGGTCTTCTACGGGG
GGTCATTTACGAAGCAATC: GTCATTTACGAAGCAATCA
TTTACAGGGTTTTGTTCTC: TTACAGGGTTTTGTTCTCT
ATAGGCATATGCCCGGGCG: TAGGCATATGCCCGGGCGT
TTGTTGTAACGCGAACCTT: TGTTGTAACGCGAACCTTG
TCGACAAAAGCACGGCATA: CGACAAAAGCACGGCATAA
TTCAGCTCACTTACATACG: TCAGCTCACTTACATACGC
GCGGATGTCGACAAAAGCA: CGGATGTCGACAAAAGCAC
GAGCTTCATACCAGGCCGT: AGCTTCATACCAGGCCGTT
CAAGTTAATCGCCGGACGC: AAGTTAATCGCCGGACGCG
GTGCGCGATGTCAATACGA: TGCGCGATGTCAATACGAT
GTTTAAAAGTATGATATAG: TTTAAAAGTATGATATAGA
AGGCGGTTATGAGATCACA: GGCGGTTATGAGATCACAA
TGTGTGACTATCTGAGAAA: GTGTGACTATCTGAGAAAG
ATCCGAGCCTTTACAGGGT: TCCGAGCCTTTACAGGGTT
CAAAAGCACGGCATAATCT: AAAAGCACGGCATAATCTT
TTATTGGATTTTCCGTATT: TATTGGATTTTCCGTATTC
ATAGAGTCAGCTGGTAGCG: TAGAGTCAGCTGGTAGCGC
CTACTGGTTGTTGTAACGC: TACTGGTTGTTGTAACGCG
AGCACGGCATAATCTTTGA: GCACGGCATAATCTTTGAC
TTAGATAGCTCCCACCTCC: TAGATAGCTCCCACCTCCC
AGGGTGAATGGTCTTCTAC: GGGTGAATGGTCTTCTACG
TCCTTGTCGATTTTCCGTA: CCTTGTCGATTTTCCGTAT
ATACTTTGACCATCAGCTA: TACTTTGACCATCAGCTAC
ATCACAAACTGTCCCCATT: TCACAAACTGTCCCCATTA
TTGTAACGCGAACCTTGAA: TGTAACGCGAACCTTGAAC
TCCGGTAGGCAGTCCCTTG: CCGGTAGGCAGTCCCTTGC
CACTTACATACGCTTGGGT: ACTTACATACGCTTGGGTA
AATGTCGACCCCCTTAATT: ATGTCGACCCCCTTAATTT
ACAAGAGAAGCGGAGCCAT: CAAGAGAAGCGGAGCCATG
TGGGTAACGGGGACAGGCA: GGGTAACGGGGACAGGCAC
AGGCACGTGGGGGGGGTGC: GGCACGTGGGGGGGGTGCT
GACGCACGGAGTAAGTAGT: ACGCACGGAGTAAGTAGTG
CGTCGAAAACTTTACCACC: GTCGAAAACTTTACCACCG
ATCACAGATTTTCCGTATT: TCACAGATTTTCCGTATTC
CAATACGATAGGCATATGC: AATACGATAGGCATATGCC
TCTTGTTTCCTGCTATGGG: CTTGTTTCCTGCTATGGGA
CATAATCTTTGACGGAGCA: ATAATCTTTGACGGAGCAT
TTGGAACCCCCCAACCGGC: TGGAACCCCCCAACCGGCG
TTTCTTTGAAGTACAGTGA: TTCTTTGAAGTACAGTGAC
AGGAGAACAGTCTAGTGCG: GGAGAACAGTCTAGTGCGC
AAAGAGCACAACAACTGTC: AAGAGCACAACAACTGTCT
GTCTACTACCGCCAACCTG: TCTACTACCGCCAACCTGC
TTCAAGGGTGGACGCACGG: TCAAGGGTGGACGCACGGA
GGCCCGGCCTGGCTCTTTG: GCCCGGCCTGGCTCTTTGA
ACGGGGGTCCTACTAACGC: CGGGGGTCCTACTAACGCG
TCCGTATTCAAGCGGATGT: CCGTATTCAAGCGGATGTC
CTTATAAAGTGAGTGCGTT: TTATAAAGTGAGTGCGTTG
GGGGTCATTTACGAAGCAA: GGGTCATTTACGAAGCAAT
CTTGCAACTTGTCGTTACC: TTGCAACTTGTCGTTACCT
GTAATACCAGTTCTAAGGA: TAATACCAGTTCTAAGGAT
TGCGGGGGACGCGAAGGGT: GCGGGGGACGCGAAGGGTG
TCGAGACAGCTTTATATGC: CGAGACAGCTTTATATGCC
GCGGGGGACGCGAAGGGTG: CGGGGGACGCGAAGGGTGA
ATTTGATCTGCTATCGAAA: TTTGATCTGCTATCGAAAC
AGAACCGAATCCCCTTTAT: GAACCGAATCCCCTTTATT
GCAGCACACTTGGAACACA: CAGCACACTTGGAACACAA
GGAGGAAGCAATTTCAGCT: GAGGAAGCAATTTCAGCTC
AAGCACCTAGTTGCAAACT: AGCACCTAGTTGCAAACTA
TATCGGGATCCGCCATTCT: ATCGGGATCCGCCATTCTT
AGGCGTTGGAGTGAGACAA: GGCGTTGGAGTGAGACAAC
CCCACAGGTATCGGGATCC: CCACAGGTATCGGGATCCG
CGTTGGAGTGAGACAACGC: GTTGGAGTGAGACAACGCA
GCGTGCCACTCAATGTAGG: CGTGCCACTCAATGTAGGT
GTGCCACTCAATGTAGGTT: TGCCACTCAATGTAGGTTT
ATGTCGTCCACCTCCTACT: TGTCGTCCACCTCCTACTG
TACCAGTTCTAAGGATTTG: ACCAGTTCTAAGGATTTGA
ATGACTGATAGAGGGCCCG: TGACTGATAGAGGGCCCGG
TCGACTGTTTTCGCTCCGT: CGACTGTTTTCGCTCCGTC
TTCCTGCTATGGGACGGCT: TCCTGCTATGGGACGGCTA
AACGGGCCTCATTAAACAT: ACGGGCCTCATTAAACATG
TTTAGATAGCTCCCACCTC: TTAGATAGCTCCCACCTCC
CATGGACTGATCTGTATAG: ATGGACTGATCTGTATAGA
CACGGAGTAAGTAGTGGCT: ACGGAGTAAGTAGTGGCTC
CGGGCTGTCGCCCTTGCAA: GGGCTGTCGCCCTTGCAAC
CCTGGCCCACAGGTATCGG: CTGGCCCACAGGTATCGGG
AAAGTGAGTGCGTTGTTAA: AAGTGAGTGCGTTGTTAAT
CCATGGATTCTTGTTTCCT: CATGGATTCTTGTTTCCTG
GCTTCATACCAGGCCGTTC: CTTCATACCAGGCCGTTCT
GGCGATTCCCAACTGGTTC: GCGATTCCCAACTGGTTCA
CGGAGCCATCCATCGAGAC: GGAGCCATCCATCGAGACA
GCGAAAGCACCTGGCCCAC: CGAAAGCACCTGGCCCACA
TTCTTGTTTCCTGCTATGG: TCTTGTTTCCTGCTATGGG
AGTCAGCTGGTAGCGCTAG: GTCAGCTGGTAGCGCTAGG
TCGCCGGACGCGAGCTAAG: CGCCGGACGCGAGCTAAGA
CAAGCGGATGTCGACAAAA: AAGCGGATGTCGACAAAAG
CCGAGCCTTTACAGGGTTT: CGAGCCTTTACAGGGTTTT
GAACGGGCCTCATTAAACA: AACGGGCCTCATTAAACAT
TTGAAAAGTGGCATGCATG: TGAAAAGTGGCATGCATGG
ACGGTGATCCAAACCGCGT: CGGTGATCCAAACCGCGTA
GGCGGCACGTCGAAAACTT: GCGGCACGTCGAAAACTTT
CAACAACTGTCTCATACGG: AACAACTGTCTCATACGGG
CAGTTCTAAGGATTTGAGC: AGTTCTAAGGATTTGAGCA
GATAGCTCCCACCTCCCAT: ATAGCTCCCACCTCCCATA
GCATAATCTTTGACGGAGC: CATAATCTTTGACGGAGCA
GTTGGAAGGCTTTCGCATC: TTGGAAGGCTTTCGCATCT
CCTTTATTAAAGCGCTACA: CTTTATTAAAGCGCTACAA
GCATTATTGGTTATACGTC: CATTATTGGTTATACGTCT
GGCAAAATAACGGGCTGTC: GCAAAATAACGGGCTGTCG
TATCGAAACACATTGTGCT: ATCGAAACACATTGTGCTT
TTTTAATGTCGACCCCCTT: TTTAATGTCGACCCCCTTA
CGGGCTTCGACTGTTTTCG: GGGCTTCGACTGTTTTCGC
CGGAGGAAGCAATTTCAGC: GGAGGAAGCAATTTCAGCT
AGCTTACCTAGAGCTCGTA: GCTTACCTAGAGCTCGTAT
TACATACGCTTGGGTAACG: ACATACGCTTGGGTAACGG
CTTGCGGGCGGTTATCACG: TTGCGGGCGGTTATCACGT
GACGCGAAGGGTGAATGGT: ACGCGAAGGGTGAATGGTC
TCGCTGGACGTGTCAGGCA: CGCTGGACGTGTCAGGCAT
CTGGCGATTCCCAACTGGT: TGGCGATTCCCAACTGGTT
TGCCCGGGCGTGAGAGCCC: GCCCGGGCGTGAGAGCCCG
GCCTCATTAAACATGGTCC: CCTCATTAAACATGGTCCG
GGAGTGAGACAACGCATGG: GAGTGAGACAACGCATGGA
CGAATTTTCCCTTGATCAT: GAATTTTCCCTTGATCATG
ATTCAGCTTTGAGGTGATT: TTCAGCTTTGAGGTGATTT
GCACGGCATAATCTTTTAC: CACGGCATAATCTTTTACG
ACGGAGCATGCGGGGGACG: CGGAGCATGCGGGGGACGC
TCTAAGCAAATTGGTAATA: CTAAGCAAATTGGTAATAC
ACGCACCTAGGCGTTGGAG: CGCACCTAGGCGTTGGAGT
TAATACTTGCCAGTCACCG: AATACTTGCCAGTCACCGT
ATTTGGTGAGTGTCATCCG: TTTGGTGAGTGTCATCCGG
GGTATCGGGATCCGCCATT: GTATCGGGATCCGCCATTC
TCCCCTAGCAACGAATTTA: CCCCTAGCAACGAATTTAG
ATTGGTAATACCAGTTCTA: TTGGTAATACCAGTTCTAA
TAATCACAGATTTTCCGTA: AATCACAGATTTTCCGTAT
GGGGGGGTGCTAGCACCAC: GGGGGGTGCTAGCACCACT
CGGAGTAAGTAGTGGCTCA: GGAGTAAGTAGTGGCTCAA
AACGTCCTCTAAAGAGCAC: ACGTCCTCTAAAGAGCACA
TCTTACATTGGAACCCCCC: CTTACATTGGAACCCCCCA
CGTCTGTTCCCTCGATTAT: GTCTGTTCCCTCGATTATA
TCTTTGAATGAGAGTGCTG: CTTTGAATGAGAGTGCTGG
AGCTTCATACCAGGCCGTT: GCTTCATACCAGGCCGTTC
TTAATGTCGACCCCCTTAA: TAATGTCGACCCCCTTAAT
TACCAGGCCGTTCTTACGG: ACCAGGCCGTTCTTACGGA
ATCGGGATCCGCCATTCTT: TCGGGATCCGCCATTCTTA
GATTTTCCGTATTCAAGCG: ATTTTCCGTATTCAAGCGG
CTGCTATGGGACGGCTACG: TGCTATGGGACGGCTACGA
GCGATTATGGTCCCCACGT: CGATTATGGTCCCCACGTC
TCCAAAGCACGGCATAATC: CCAAAGCACGGCATAATCT
GAACCTTGAACGGGCCTCA: AACCTTGAACGGGCCTCAT
CCCGGGCGTGAGAGCCCGT: CCGGGCGTGAGAGCCCGTC
AAAGAACCGAATCCCCTTT: AAGAACCGAATCCCCTTTA
TACAAACTCAACCTGCGGA: ACAAACTCAACCTGCGGAG
TTTGTGTGACTATCTGAGA: TTGTGTGACTATCTGAGAA
GAAAAGCACGGCATAATCT: AAAAGCACGGCATAATCTT
ACGGCATAATCTTTACGCA: CGGCATAATCTTTACGCAC
CCACCGGTCTCTGAGGGAC: CACCGGTCTCTGAGGGACT
ACCTAGGCGTTGGAGTGAG: CCTAGGCGTTGGAGTGAGA
ATGGCGGGCTTCGACTGTT: TGGCGGGCTTCGACTGTTT
GCTCCGTCCGGGACAAGAG: CTCCGTCCGGGACAAGAGA
AACCTTGAACGGGCCTCAT: ACCTTGAACGGGCCTCATT
GAAAAGTGGCATGCATGGC: AAAAGTGGCATGCATGGCG
GCATCCGGTAGGCAGTCCC: CATCCGGTAGGCAGTCCCT
TAGCAACGAATTTAGCAAG: AGCAACGAATTTAGCAAGC
CCTTGATCATGCGTGCCAC: CTTGATCATGCGTGCCACT
GGCACGTCGAAAACTTTAC: GCACGTCGAAAACTTTACC
CTGGCGGCACGTCGAAAAC: TGGCGGCACGTCGAAAACT
GCCCGGCCTGGCTCTTTGA: CCCGGCCTGGCTCTTTGAA
TTAAAACACTGGTATATTT: TAAAACACTGGTATATTTG
TCCCCACGTCACGTTTAAA: CCCCACGTCACGTTTAAAA
GTGATTTTCCGTATTCAAG: TGATTTTCCGTATTCAAGC
ACTTCTTACATTGGAACCC: CTTCTTACATTGGAACCCC
CGGGACAAGAGAAGCGGAG: GGGACAAGAGAAGCGGAGC
CGATAGGCATATGCCCGGG: GATAGGCATATGCCCGGGC
GTCCTCTAAAGAGCACAAC: TCCTCTAAAGAGCACAACA
GATGTCTACTACCGCCAAC: ATGTCTACTACCGCCAACC
ATCTGTATAGAGCGATGTG: TCTGTATAGAGCGATGTGA
TTAATCCTGTTGTAAGGCG: TAATCCTGTTGTAAGGCGT
TCGAGCAAATTAAAACACT: CGAGCAAATTAAAACACTG
AGGTATCGGGATCCGCCAT: GGTATCGGGATCCGCCATT
CGCTTGGGTAACGGGGACA: GCTTGGGTAACGGGGACAG
TATAGAGTTCAAAGTCGCG: ATAGAGTTCAAAGTCGCGA
CCACCTCAGTTCCCCAAAA: CACCTCAGTTCCCCAAAAT
CATTGGAACCCCCCAACCG: ATTGGAACCCCCCAACCGG
CTCAATGTAGGTTTTAATG: TCAATGTAGGTTTTAATGT
TGACACGGTGATCCAAACC: GACACGGTGATCCAAACCG
CTTCGACTGTTTTCGCTCC: TTCGACTGTTTTCGCTCCG
ATACCAGGCCGTTCTTACG: TACCAGGCCGTTCTTACGG
GAACACAATTCTGCCCATG: AACACAATTCTGCCCATGG
TGTTAGGTGGAGTCGAGCA: GTTAGGTGGAGTCGAGCAA
AATGGTCTTCTACGGGGGT: ATGGTCTTCTACGGGGGTC
TTACGCACTCCGGAGCCAT: TACGCACTCCGGAGCCATC
GAGCTTACCTAGAGCTCGT: AGCTTACCTAGAGCTCGTA
GCATAATCTTTTACGCACT: CATAATCTTTTACGCACTC
GGCCTGGCTCTTTGAATGA: GCCTGGCTCTTTGAATGAG
TCCCCATTAAGCACCTAGT: CCCCATTAAGCACCTAGTT
GAGCAAATTAAAACACTGG: AGCAAATTAAAACACTGGT
AATTTAGCAAGCGAATTTT: ATTTAGCAAGCGAATTTTC
GCATGGACTGATCTGTATA: CATGGACTGATCTGTATAG
AGGTGGAGTCGAGCAAATT: GGTGGAGTCGAGCAAATTA
AACATGGTCCGGATCGTCG: ACATGGTCCGGATCGTCGC
GTCCCCATTAAGCACCTAG: TCCCCATTAAGCACCTAGT
TCCTGTTGTAAGGCGTACC: CCTGTTGTAAGGCGTACCC
GATTTGAGCATTATTGGTT: ATTTGAGCATTATTGGTTA
CTCAACGTCCTCTAAAGAG: TCAACGTCCTCTAAAGAGC
CCGGCGGTGCATGACTGAT: CGGCGGTGCATGACTGATA
CACTCAATGTAGGTTTTAA: ACTCAATGTAGGTTTTAAT
GTTAGGTGGAGTCGAGCAA: TTAGGTGGAGTCGAGCAAA
CAGTCTAGTGCGCGATGTC: AGTCTAGTGCGCGATGTCA
CCCAACCGGCGGTGCATGA: CCAACCGGCGGTGCATGAC
TTACCATAGGCCCCTCGCA: TACCATAGGCCCCTCGCAT
CCGGGCGTGAGAGCCCGTC: CGGGCGTGAGAGCCCGTCA
TGAGGTGATTTTCCGTATT: GAGGTGATTTTCCGTATTC
CGGAGCTCAAGGTTCCGGG: GGAGCTCAAGGTTCCGGGC
CGAGTCAGCCATTCAGCTT: GAGTCAGCCATTCAGCTTT
ACATGGTCCGGATCGTCGC: CATGGTCCGGATCGTCGCT
GCGGGATAGAGTCAGCTGG: CGGGATAGAGTCAGCTGGT
TAACGGGGACAGGCACGTG: AACGGGGACAGGCACGTGG
GACAGGCACGTGGGGGGGG: ACAGGCACGTGGGGGGGGT
CCGTATTCAAGCTGCCAAG: CGTATTCAAGCTGCCAAGT
AGAGTTCAAAGTCGCGACG: GAGTTCAAAGTCGCGACGG
ACCTAGTTGCAAACTATCC: CCTAGTTGCAAACTATCCT
GAGGAAGCAATTTCAGCTC: AGGAAGCAATTTCAGCTCA
TCCTACTGGTTGTTGTAAC: CCTACTGGTTGTTGTAACG
GGGGGTGCTAGCACCACTT: GGGGTGCTAGCACCACTTC
ACCATTACCATAGGCCCCT: CCATTACCATAGGCCCCTC
AACTATCCCTATTTAAGGC: ACTATCCCTATTTAAGGCG
TGCGCGATGTCAATACGAT: GCGCGATGTCAATACGATA
TTCTTACATTGGAACCCCC: TCTTACATTGGAACCCCCC
CATGGATTCTTGTTTCCTG: ATGGATTCTTGTTTCCTGC
GTCCACCTCCTACTGGTTG: TCCACCTCCTACTGGTTGT
TAGCAAGCGAATTTTCCCT: AGCAAGCGAATTTTCCCTT
GACCATCAGCTACTAATTA: ACCATCAGCTACTAATTAC
CCAGTTCTAAGGATTTGAG: CAGTTCTAAGGATTTGAGC
CTGGTATATTTGGTGAGTG: TGGTATATTTGGTGAGTGT
TTTCAGCTCACTTACATAC: TTCAGCTCACTTACATACG
AATCGCCGGACGCGAGCTA: ATCGCCGGACGCGAGCTAA
TGTGCTTTCCATCACCTGT: GTGCTTTCCATCACCTGTT
AAGATTTGATCTGCTATCG: AGATTTGATCTGCTATCGA
GTGCTTTCCATCACCTGTT: TGCTTTCCATCACCTGTTA
ACAGTCTAGTGCGCGATGT: CAGTCTAGTGCGCGATGTC
GGGAGCACCCAAGTTAATC: GGAGCACCCAAGTTAATCA
CATTTACGAAGCAATCATC: ATTTACGAAGCAATCATCG
AAGTTTGAAAAGTGGCATG: AGTTTGAAAAGTGGCATGC
AATACGATAGGCATATGCC: ATACGATAGGCATATGCCC
CGGGGGTCCTACTAACGCG: GGGGGTCCTACTAACGCGA
GCTTGGGTAACGGGGACAG: CTTGGGTAACGGGGACAGG
TCACGTTTAAAAGTATGAT: CACGTTTAAAAGTATGATA
TCTGGCGTATCTCAATGTG: CTGGCGTATCTCAATGTGC
ATTGTGCTTTCCATCACCT: TTGTGCTTTCCATCACCTG
GCGTACCCAAGTTTGAAAA: CGTACCCAAGTTTGAAAAG
CCTGGCTCTTTGAATGAGA: CTGGCTCTTTGAATGAGAG
GACACGGTGATCCAAACCG: ACACGGTGATCCAAACCGC
ATGGATTCTTGTTTCCTGC: TGGATTCTTGTTTCCTGCT
GCCGGGCCTCTAAGCAAAT: CCGGGCCTCTAAGCAAATT
TTCTGCCCATGGAGGATGA: TCTGCCCATGGAGGATGAT
GCCATCCATCGAGACAGCT: CCATCCATCGAGACAGCTT
TTGGAGTGAGACAACGCAT: TGGAGTGAGACAACGCATG
TTCTTTGAAGTACAGTGAC: TCTTTGAAGTACAGTGACA
GATAACTATCCCTATTTAA: ATAACTATCCCTATTTAAG
TCCTCACCTCAACGTCCTC: CCTCACCTCAACGTCCTCT
CCAACTGGTTCAAGGGTGG: CAACTGGTTCAAGGGTGGA
TAAGGCGTACCCAAGTTTG: AAGGCGTACCCAAGTTTGA
AATCCCTAAAAAGCACGGC: ATCCCTAAAAAGCACGGCA
GGACTCGCTTAACAGTTCG: GACTCGCTTAACAGTTCGT
GAAGCAATTTCAGCTCACT: AAGCAATTTCAGCTCACTT
ATGATATAGAGTTCAAAGT: TGATATAGAGTTCAAAGTC
AAACCGCGTACAAACTCAA: AACCGCGTACAAACTCAAC
GGCATAATCTTTGACGGAG: GCATAATCTTTGACGGAGC
GGACCATTACCATAGGCCC: GACCATTACCATAGGCCCC
CCGGACGCGAGCTAAGATT: CGGACGCGAGCTAAGATTT
TGAAACCCACCTCAGTTCC: GAAACCCACCTCAGTTCCC
TACGCACCTAGGCGTTGGA: ACGCACCTAGGCGTTGGAG
TCTTTGACGGAGCATGCGG: CTTTGACGGAGCATGCGGG
TAAAAAGCACGGCATAATC: AAAAAGCACGGCATAATCT
GGCTACGAATCGTAGTGAA: GCTACGAATCGTAGTGAAA
TGTGGGTACACGGGGAGCA: GTGGGTACACGGGGAGCAC
AACGAATTTAGCAAGCGAA: ACGAATTTAGCAAGCGAAT
CACCTCCTACTGGTTGTTG: ACCTCCTACTGGTTGTTGT
CAACGAATTTAGCAAGCGA: AACGAATTTAGCAAGCGAA
ACACGGGGAGCACCCAAGT: CACGGGGAGCACCCAAGTT
CCCCCCAACCGGCGGTGCA: CCCCCAACCGGCGGTGCAT
CTGGTAGCGCTAGGTTAAA: TGGTAGCGCTAGGTTAAAT
CACAGATTTTCCGTATTCA: ACAGATTTTCCGTATTCAA
GAGAGTGCTGGCGATTCCC: AGAGTGCTGGCGATTCCCA
CAAGTTTGAAAAGTGGCAT: AAGTTTGAAAAGTGGCATG
TGGTCCGGATCGTCGCTGG: GGTCCGGATCGTCGCTGGA
CAGGGCAAAATAACGGGCT: AGGGCAAAATAACGGGCTG
GCGATGTGATAACTATCCC: CGATGTGATAACTATCCCT
GTCCGGATCGTCGCTGGAC: TCCGGATCGTCGCTGGACG
CACGGCATAATCTTTATTG: ACGGCATAATCTTTATTGG
GATAGAGTCAGCTGGTAGC: ATAGAGTCAGCTGGTAGCG
GGTGATCCAAACCGCGTAC: GTGATCCAAACCGCGTACA
GGCGGGCTTCGACTGTTTT: GCGGGCTTCGACTGTTTTC
TCGCGACGGAGACGGAGGA: CGCGACGGAGACGGAGGAA
GGGGGACGCGAAGGGTGAA: GGGGACGCGAAGGGTGAAT
GATTATAGATCCGAGCCTT: ATTATAGATCCGAGCCTTT
CGGCCTGGCTCTTTGAATG: GGCCTGGCTCTTTGAATGA
TTCTCTGGCGGCACGTCGA: TCTCTGGCGGCACGTCGAA
TTCCTGTGGGTACACGGGG: TCCTGTGGGTACACGGGGA
TACACTTATAAAGTGAGTG: ACACTTATAAAGTGAGTGC
ACGGCATAATCTTTGACGG: CGGCATAATCTTTGACGGA
TGGCGGCACGTCGAAAACT: GGCGGCACGTCGAAAACTT
ATACGGGGTCATTTACGAA: TACGGGGTCATTTACGAAG
GATAGAGGGCCCGGCCTGG: ATAGAGGGCCCGGCCTGGC
AGTTAATCGCCGGACGCGA: GTTAATCGCCGGACGCGAG
GAATTTTCCCTTGATCATG: AATTTTCCCTTGATCATGC
GAGCTCGTATATAGACCGG: AGCTCGTATATAGACCGGT
GCGAGCTAAGATTTGATCT: CGAGCTAAGATTTGATCTG
CATATCCTTGTCGATTTTC: ATATCCTTGTCGATTTTCC
CACGTCACGTTTAAAAGTA: ACGTCACGTTTAAAAGTAT
TACAAGTTAATCGCCGGAC: ACAAGTTAATCGCCGGACG
GAATGGTCTTCTACGGGGG: AATGGTCTTCTACGGGGGT
TAGCAGCACACTTGGAACA: AGCAGCACACTTGGAACAC
CGGTGCATGACTGATAGAG: GGTGCATGACTGATAGAGG
TATCCCTATTTAAGGCGGT: ATCCCTATTTAAGGCGGTT
AGTGCTGGCGATTCCCAAC: GTGCTGGCGATTCCCAACT
GGATTTTCCGTATTCAAGC: GATTTTCCGTATTCAAGCG
GTGTCAGGCATCCGGTAGG: TGTCAGGCATCCGGTAGGC
TACTAATTACCGGGGCTAA: ACTAATTACCGGGGCTAAC
GATCACAAACTGTCCCCAT: ATCACAAACTGTCCCCATT
GACTGATAGAGGGCCCGGC: ACTGATAGAGGGCCCGGCC
CTTGGGTAACGGGGACAGG: TTGGGTAACGGGGACAGGC
CCCACCTCAGTTCCCCAAA: CCACCTCAGTTCCCCAAAA
CATGCGGGGGACGCGAAGG: ATGCGGGGGACGCGAAGGG
CACTTCTTACATTGGAACC: ACTTCTTACATTGGAACCC
TAACGCGAAAGCACCTGGC: AACGCGAAAGCACCTGGCC
CCTTGAACGGGCCTCATTA: CTTGAACGGGCCTCATTAA
TCAAGCAACTACTGTCCAA: CAAGCAACTACTGTCCAAA
CGCTAGGTTAAATCTAGCA: GCTAGGTTAAATCTAGCAG
ACTTATAAAGTGAGTGCGT: CTTATAAAGTGAGTGCGTT
TCGGAGCTCAAGGTTCCGG: CGGAGCTCAAGGTTCCGGG
TTTGAAGTACAGTGACACG: TTGAAGTACAGTGACACGG
ATCTTTGACGGAGCATGCG: TCTTTGACGGAGCATGCGG
TGTCAGGCATCCGGTAGGC: GTCAGGCATCCGGTAGGCA
GGCTAACGTCCCCTAGCAA: GCTAACGTCCCCTAGCAAC
GCCCATGGAGGATGATGTC: CCCATGGAGGATGATGTCT
TGCTGGCGATTCCCAACTG: GCTGGCGATTCCCAACTGG
TGGCTCAAGCCGAGCTTCA: GGCTCAAGCCGAGCTTCAT
AGTAATACGCAGAAGGAGA: GTAATACGCAGAAGGAGAA
CAAGCCGAGCTTCATACCA: AAGCCGAGCTTCATACCAG
AATCCTGTTGTAAGGCGTA: ATCCTGTTGTAAGGCGTAC
ACAGGGTTTTGTTCTCTGG: CAGGGTTTTGTTCTCTGGC
ATATGCCCGGGCGTGAGAG: TATGCCCGGGCGTGAGAGC
TGGAGTCGAGCAAATTAAA: GGAGTCGAGCAAATTAAAA
ACCCCCCAACCGGCGGTGC: CCCCCCAACCGGCGGTGCA
GCCGTTCTTACGGACCATT: CCGTTCTTACGGACCATTA
AAGCAAATTGGTAATACCA: AGCAAATTGGTAATACCAG
TCTCATACGGGGTCATTTA: CTCATACGGGGTCATTTAC
CAGGCCGTTCTTACGGACC: AGGCCGTTCTTACGGACCA
TCTACGGGGGTCCTACTAA: CTACGGGGGTCCTACTAAC
ATCCCCTTTATTAAAGCGC: TCCCCTTTATTAAAGCGCT
GAACCCCCCAACCGGCGGT: AACCCCCCAACCGGCGGTG
ACGCGAAGGGTGAATGGTC: CGCGAAGGGTGAATGGTCT
AACGGGCTGTCGCCCTTGC: ACGGGCTGTCGCCCTTGCA
CAGTTCCCCAAAATCGCAA: AGTTCCCCAAAATCGCAAT
ATGCCTGCGGATTCAGGGC: TGCCTGCGGATTCAGGGCA
GTAGGCAGTCCCTTGCGGG: TAGGCAGTCCCTTGCGGGC
CAATTCTGCCCATGGAGGA: AATTCTGCCCATGGAGGAT
GCACGTGGGGGGGGTGCTA: CACGTGGGGGGGGTGCTAG
CCGCCATTCTTAGGTCCAG: CGCCATTCTTAGGTCCAGT
GCGTTGGAGTGAGACAACG: CGTTGGAGTGAGACAACGC
CGAAGCAATCATCGAGTCA: GAAGCAATCATCGAGTCAG
CACCTGTTAGGTGGAGTCG: ACCTGTTAGGTGGAGTCGA
TCGAAACACATTGTGCTTT: CGAAACACATTGTGCTTTC
TCCTGCTATGGGACGGCTA: CCTGCTATGGGACGGCTAC
TTATATGCCTGCGGATTCA: TATATGCCTGCGGATTCAG
ATGCGGGGGACGCGAAGGG: TGCGGGGGACGCGAAGGGT
GGCGGTTATGAGATCACAA: GCGGTTATGAGATCACAAA
CTTTGAGGTGATTTTCCGT: TTTGAGGTGATTTTCCGTA
GCACACTTGGAACACAATT: CACACTTGGAACACAATTC
CTTCTTACATTGGAACCCC: TTCTTACATTGGAACCCCC
AAAACTTTACCACCGGTCT: AAACTTTACCACCGGTCTC
CCGGATCGTCGCTGGACGT: CGGATCGTCGCTGGACGTG
ATCCTTGTCGATTTTCCGT: TCCTTGTCGATTTTCCGTA
GCTTTATATGCCTGCGGAT: CTTTATATGCCTGCGGATT
ATCTGAGAAAGAACCGAAT: TCTGAGAAAGAACCGAATC
GTCATCCGGTTGGAAGGCT: TCATCCGGTTGGAAGGCTT
CCACCTCCCATATCCTTGT: CACCTCCCATATCCTTGTC
TTGTCGATTTTCCGTATTC: TGTCGATTTTCCGTATTCA
TGCAACTTGTCGTTACCTT: GCAACTTGTCGTTACCTTG
GGAAGCAATTTCAGCTCAC: GAAGCAATTTCAGCTCACT
ACACTTATAAAGTGAGTGC: CACTTATAAAGTGAGTGCG
TCCCATATCCTTGTCGATT: CCCATATCCTTGTCGATTT
GCGACGGAGACGGAGGAAG: CGACGGAGACGGAGGAAGC
AAGCACCTGGCCCACAGGT: AGCACCTGGCCCACAGGTA
GGACGTGTCAGGCATCCGG: GACGTGTCAGGCATCCGGT
TCAAGCGGATGTCGACAAA: CAAGCGGATGTCGACAAAA
TAATCGCCGGACGCGAGCT: AATCGCCGGACGCGAGCTA
AAGCGGAGCCATGGATTCT: AGCGGAGCCATGGATTCTT
AGGTTTTAATGTCGACCCC: GGTTTTAATGTCGACCCCC
TCCATCGAGACAGCTTTAT: CCATCGAGACAGCTTTATA
ACCGAATCCCCTTTATTAA: CCGAATCCCCTTTATTAAA
CCGGGCCTCTAAGCAAATT: CGGGCCTCTAAGCAAATTG
ACTTGTCGTTACCTTGTCG: CTTGTCGTTACCTTGTCGG
TATCCTTAATACTTGCCAG: ATCCTTAATACTTGCCAGT
CCCCAACCGGCGGTGCATG: CCCAACCGGCGGTGCATGA
CGTTCTTACGGACCATTAC: GTTCTTACGGACCATTACC
AGCTTTATATGCCTGCGGA: GCTTTATATGCCTGCGGAT
AGTCGAGCAAATTAAAACA: GTCGAGCAAATTAAAACAC
CATCAGCTACTAATTACCG: ATCAGCTACTAATTACCGG
TCACGTAAATACACTTATA: CACGTAAATACACTTATAA
GGTTCCGGGCGGGATAGAG: GTTCCGGGCGGGATAGAGT
ATACACTTATAAAGTGAGT: TACACTTATAAAGTGAGTG
GTATTCAAGCAACTACTGT: TATTCAAGCAACTACTGTC
TCTCCTCACCTCAACGTCC: CTCCTCACCTCAACGTCCT
ATTAAAGCGCTACAAGTTA: TTAAAGCGCTACAAGTTAA
ACGGGCCTCATTAAACATG: CGGGCCTCATTAAACATGG
CGGTTATGAGATCACAAAC: GGTTATGAGATCACAAACT
CTGTCCAAAGCACGGCATA: TGTCCAAAGCACGGCATAA
GCGTTGTTAATCCTGTTGT: CGTTGTTAATCCTGTTGTA
TTGTCGGAGCTCAAGGTTC: TGTCGGAGCTCAAGGTTCC
GTGATCCAAACCGCGTACA: TGATCCAAACCGCGTACAA
TTATTAAAGCGCTACAAGT: TATTAAAGCGCTACAAGTT
ACTATCCTTAATACTTGCC: CTATCCTTAATACTTGCCA
ACAGCTTTATATGCCTGCG: CAGCTTTATATGCCTGCGG
CGTATTCAAGCTGCCAAGT: GTATTCAAGCTGCCAAGTG
GGGACAAGAGAAGCGGAGC: GGACAAGAGAAGCGGAGCC
TATATAGACCGGTCTTTTT: ATATAGACCGGTCTTTTTG
TCTTCTACGGGGGTCCTAC: CTTCTACGGGGGTCCTACT
TGTCATCCGGTTGGAAGGC: GTCATCCGGTTGGAAGGCT
AATCGCAATCGGATTGGTC: ATCGCAATCGGATTGGTCG
ATCGTAGTGAAACCCACCT: TCGTAGTGAAACCCACCTC
TGGAACACAATTCTGCCCA: GGAACACAATTCTGCCCAT
CGTACCCAAGTTTGAAAAG: GTACCCAAGTTTGAAAAGT
CAGGCACGTGGGGGGGGTG: AGGCACGTGGGGGGGGTGC
GGCTCTTTGAATGAGAGTG: GCTCTTTGAATGAGAGTGC
GTCAATACGATAGGCATAT: TCAATACGATAGGCATATG
GACGGAGACGGAGGAAGCA: ACGGAGACGGAGGAAGCAA
TCGGATTGGTCGAAGTATA: CGGATTGGTCGAAGTATAC
ATCGTCGCTGGACGTGTCA: TCGTCGCTGGACGTGTCAG
TGGCCCACAGGTATCGGGA: GGCCCACAGGTATCGGGAT
AACACAATTCTGCCCATGG: ACACAATTCTGCCCATGGA
CCCTATTTAAGGCGGTTAT: CCTATTTAAGGCGGTTATG
TGCCTACTGCGCGATTATG: GCCTACTGCGCGATTATGG
TGGCGATTCCCAACTGGTT: GGCGATTCCCAACTGGTTC
TATGCCTGCGGATTCAGGG: ATGCCTGCGGATTCAGGGC
AGTTGCAAACTATCCTTAA: GTTGCAAACTATCCTTAAT
CATCGAGACAGCTTTATAT: ATCGAGACAGCTTTATATG
TTCCCTCGATTATAGATCC: TCCCTCGATTATAGATCCG
GTGGAGTCGAGCAAATTAA: TGGAGTCGAGCAAATTAAA
AGGGTGGACGCACGGAGTA: GGGTGGACGCACGGAGTAA
CACGGCATAATCTTTTACG: ACGGCATAATCTTTTACGC
CTAATTACCGGGGCTAACG: TAATTACCGGGGCTAACGT
CTCCGGAGCCATCCATCGA: TCCGGAGCCATCCATCGAG
TTATACGTCTGTTCCCTCG: TATACGTCTGTTCCCTCGA
AACGTCCCCTAGCAACGAA: ACGTCCCCTAGCAACGAAT
TCCGTATTCAAGCTGCCAA: CCGTATTCAAGCTGCCAAG
GGGCAAAATAACGGGCTGT: GGCAAAATAACGGGCTGTC
CGGGGACAGGCACGTGGGG: GGGGACAGGCACGTGGGGG
CGAAACACATTGTGCTTTC: GAAACACATTGTGCTTTCC
TTTAAAAGTATGATATAGA: TTAAAAGTATGATATAGAG
GTCCCTTGCGGGCGGTTAT: TCCCTTGCGGGCGGTTATC
ATTTAGCAAGCGAATTTTC: TTTAGCAAGCGAATTTTCC
AGCCGAATCCCTAAAAAGC: GCCGAATCCCTAAAAAGCA
ATCTTTACGCACCTAGGCG: TCTTTACGCACCTAGGCGT
ATACGATAGGCATATGCCC: TACGATAGGCATATGCCCG
GAGCATTATTGGTTATACG: AGCATTATTGGTTATACGT
GGGGTCCTACTAACGCGAA: GGGTCCTACTAACGCGAAA
GGTTCAAGGGTGGACGCAC: GTTCAAGGGTGGACGCACG
TCGTAGTGAAACCCACCTC: CGTAGTGAAACCCACCTCA
TAATTTCTTTGAAGTACAG: AATTTCTTTGAAGTACAGT
TTTCCATCACCTGTTAGGT: TTCCATCACCTGTTAGGTG
ACCTCCTACTGGTTGTTGT: CCTCCTACTGGTTGTTGTA
TCGTCTGGCGTATCTCAAT: CGTCTGGCGTATCTCAATG
AAGGGTGGACGCACGGAGT: AGGGTGGACGCACGGAGTA
TTCTTACGGACCATTACCA: TCTTACGGACCATTACCAT
TGGATTTTCCGTATTCAAG: GGATTTTCCGTATTCAAGC
AGCACCTGGCCCACAGGTA: GCACCTGGCCCACAGGTAT
CTCCCACCTCCCATATCCT: TCCCACCTCCCATATCCTT
TTCCGTATTCAAGCAACTA: TCCGTATTCAAGCAACTAC
CCGGCCTGGCTCTTTGAAT: CGGCCTGGCTCTTTGAATG
TGGCGTATCTCAATGTGCC: GGCGTATCTCAATGTGCCT
TTCTGTGGAACTAATATGT: TCTGTGGAACTAATATGTC
GTTCTGTGGAACTAATATG: TTCTGTGGAACTAATATGT
TCAGCTCACTTACATACGC: CAGCTCACTTACATACGCT
CAACTGTCTCATACGGGGT: AACTGTCTCATACGGGGTC
CGTGCCACTCAATGTAGGT: GTGCCACTCAATGTAGGTT
TAATCTTTATTGGATTTTC: AATCTTTATTGGATTTTCC
ACGTCACGTTTAAAAGTAT: CGTCACGTTTAAAAGTATG
CCTTAATTTCTTTGAAGTA: CTTAATTTCTTTGAAGTAC
CTAGTTGCAAACTATCCTT: TAGTTGCAAACTATCCTTA
TTCCGTATTCAAGCGGATG: TCCGTATTCAAGCGGATGT
ATGTCTACTACCGCCAACC: TGTCTACTACCGCCAACCT
CGCGAGCTAAGATTTGATC: GCGAGCTAAGATTTGATCT
TCGTTACCTTGTCGGAGCT: CGTTACCTTGTCGGAGCTC
GCACCTAGGCGTTGGAGTG: CACCTAGGCGTTGGAGTGA
CTGTTAGGTGGAGTCGAGC: TGTTAGGTGGAGTCGAGCA
TCTGCCCATGGAGGATGAT: CTGCCCATGGAGGATGATG
GTGACTATCTGAGAAAGAA: TGACTATCTGAGAAAGAAC
ACTTTTCCTGTGGGTACAC: CTTTTCCTGTGGGTACACG
GGCATAATCTTTTACGCAC: GCATAATCTTTTACGCACT
CAAACCGCGTACAAACTCA: AAACCGCGTACAAACTCAA
ACGGAGGAAGCAATTTCAG: CGGAGGAAGCAATTTCAGC
TCAGCTGGTAGCGCTAGGT: CAGCTGGTAGCGCTAGGTT
GAGACGGAGGAAGCAATTT: AGACGGAGGAAGCAATTTC
ATGGTCCGGATCGTCGCTG: TGGTCCGGATCGTCGCTGG
GAGTCAGCCATTCAGCTTT: AGTCAGCCATTCAGCTTTG
CATTTAGATAGCTCCCACC: ATTTAGATAGCTCCCACCT
GGATTCTTGTTTCCTGCTA: GATTCTTGTTTCCTGCTAT
AAACCCACCTCAGTTCCCC: AACCCACCTCAGTTCCCCA
GACCGGTCTTTTTGTGTGA: ACCGGTCTTTTTGTGTGAC
TCTGGCGGCACGTCGAAAA: CTGGCGGCACGTCGAAAAC
TTTATATGCCTGCGGATTC: TTATATGCCTGCGGATTCA
GGGACGGCTACGAATCGTA: GGACGGCTACGAATCGTAG
CGGATTGGTCGAAGTATAC: GGATTGGTCGAAGTATACT
CCTCATTAAACATGGTCCG: CTCATTAAACATGGTCCGG
TCCGGGACAAGAGAAGCGG: CCGGGACAAGAGAAGCGGA
TTGATCTGCTATCGAAACA: TGATCTGCTATCGAAACAC
GCTAGGTTAAATCTAGCAG: CTAGGTTAAATCTAGCAGC
TCCGTCCGGGACAAGAGAA: CCGTCCGGGACAAGAGAAG
CAGGCATCCGGTAGGCAGT: AGGCATCCGGTAGGCAGTC
CGGAGCCATGGATTCTTGT: GGAGCCATGGATTCTTGTT
ACCGCCAACCTGCCGGGCC: CCGCCAACCTGCCGGGCCT
TCTACTACCGCCAACCTGC: CTACTACCGCCAACCTGCC
CTGCGGATTCAGGGCAAAA: TGCGGATTCAGGGCAAAAT
CGCTTAACAGTTCGTCTGG: GCTTAACAGTTCGTCTGGC
CTATCGAAACACATTGTGC: TATCGAAACACATTGTGCT
CTGGCGTATCTCAATGTGC: TGGCGTATCTCAATGTGCC
TGTTCCCTCGATTATAGAT: GTTCCCTCGATTATAGATC
ATTGGTTATACGTCTGTTC: TTGGTTATACGTCTGTTCC
CAGCACACTTGGAACACAA: AGCACACTTGGAACACAAT
GCGGATTCAGGGCAAAATA: CGGATTCAGGGCAAAATAA
AGCAAGCGAATTTTCCCTT: GCAAGCGAATTTTCCCTTG
ACGATAGGCATATGCCCGG: CGATAGGCATATGCCCGGG
AGTGGCTCAAGCCGAGCTT: GTGGCTCAAGCCGAGCTTC
CATGGAGGATGATGTCTAC: ATGGAGGATGATGTCTACT
TGGACGTGTCAGGCATCCG: GGACGTGTCAGGCATCCGG
AGATAGCTCCCACCTCCCA: GATAGCTCCCACCTCCCAT
CGTCTGGCGTATCTCAATG: GTCTGGCGTATCTCAATGT
CGAACCTTGAACGGGCCTC: GAACCTTGAACGGGCCTCA
GTCGATTTTCCGTATTCAA: TCGATTTTCCGTATTCAAG
GGTGATTTTCCGTATTCAA: GTGATTTTCCGTATTCAAG
ATCTTTATTGGATTTTCCG: TCTTTATTGGATTTTCCGT
GGTTATACGTCTGTTCCCT: GTTATACGTCTGTTCCCTC
CTGGTTCAAGGGTGGACGC: TGGTTCAAGGGTGGACGCA
GCACCCAAGTTAATCACAG: CACCCAAGTTAATCACAGA
ACTACTGTCCAAAGCACGG: CTACTGTCCAAAGCACGGC
TATTCAAGCGGATGTCGAC: ATTCAAGCGGATGTCGACA
GTAGTGAAACCCACCTCAG: TAGTGAAACCCACCTCAGT
CAAGGGTGGACGCACGGAG: AAGGGTGGACGCACGGAGT
AAAATCGCAATCGGATTGG: AAATCGCAATCGGATTGGT
ACGCGAACCTTGAACGGGC: CGCGAACCTTGAACGGGCC
CGAAGTATACTTTGACCAT: GAAGTATACTTTGACCATC
ACGTAAATACACTTATAAA: CGTAAATACACTTATAAAG
AGTCGCGACGGAGACGGAG: GTCGCGACGGAGACGGAGG
CCACTCAATGTAGGTTTTA: CACTCAATGTAGGTTTTAA
GCCGAGCTTCATACCAGGC: CCGAGCTTCATACCAGGCC
ATGTAGGTTTTAATGTCGA: TGTAGGTTTTAATGTCGAC
CGACGGAGACGGAGGAAGC: GACGGAGACGGAGGAAGCA
TTCATACCAGGCCGTTCTT: TCATACCAGGCCGTTCTTA
AAGCACGGCATAATCTTTT: AGCACGGCATAATCTTTTA
ATCCTGTTGTAAGGCGTAC: TCCTGTTGTAAGGCGTACC
GAAACCCACCTCAGTTCCC: AAACCCACCTCAGTTCCCC
TGAGAGTGCTGGCGATTCC: GAGAGTGCTGGCGATTCCC
AGGCATATGCCCGGGCGTG: GGCATATGCCCGGGCGTGA
AAGCTGCCAAGTGGAAAAG: AGCTGCCAAGTGGAAAAGC
GAGCCATCCATCGAGACAG: AGCCATCCATCGAGACAGC
GGTGAGTGTCATCCGGTTG: GTGAGTGTCATCCGGTTGG
GTTCGTCTGGCGTATCTCA: TTCGTCTGGCGTATCTCAA
CGGTGATCCAAACCGCGTA: GGTGATCCAAACCGCGTAC
ATAATCTTTGACGGAGCAT: TAATCTTTGACGGAGCATG
CTTACGGACCATTACCATA: TTACGGACCATTACCATAG
GCATGCGGGGGACGCGAAG: CATGCGGGGGACGCGAAGG
GGACGCGAAGGGTGAATGG: GACGCGAAGGGTGAATGGT
GTCCCCACGTCACGTTTAA: TCCCCACGTCACGTTTAAA
ATTTAAGGCGGTTATGAGA: TTTAAGGCGGTTATGAGAT
GTCGTTACCTTGTCGGAGC: TCGTTACCTTGTCGGAGCT
CGTAGTGAAACCCACCTCA: GTAGTGAAACCCACCTCAG
GACAAGAGAAGCGGAGCCA: ACAAGAGAAGCGGAGCCAT
TCGCTCCGTCCGGGACAAG: CGCTCCGTCCGGGACAAGA
TCAACTTTTCCTGTGGGTA: CAACTTTTCCTGTGGGTAC
TATCACGTAAATACACTTA: ATCACGTAAATACACTTAT
CGGACCATTACCATAGGCC: GGACCATTACCATAGGCCC
CTACCGCCAACCTGCCGGG: TACCGCCAACCTGCCGGGC
TACTTGCCAGTCACCGTAG: ACTTGCCAGTCACCGTAGG
TGGTATATTTGGTGAGTGT: GGTATATTTGGTGAGTGTC
TATTCAAGCAACTACTGTC: ATTCAAGCAACTACTGTCC
CTTTTACGCACTCCGGAGC: TTTTACGCACTCCGGAGCC
CAATGTAGGTTTTAATGTC: AATGTAGGTTTTAATGTCG
TTGGAACACAATTCTGCCC: TGGAACACAATTCTGCCCA
CCACTTCTTACATTGGAAC: CACTTCTTACATTGGAACC
CTACTAACGCGAAAGCACC: TACTAACGCGAAAGCACCT
ATCACGTAAATACACTTAT: TCACGTAAATACACTTATA
TAACTATCCCTATTTAAGG: AACTATCCCTATTTAAGGC
GTCCCCTAGCAACGAATTT: TCCCCTAGCAACGAATTTA
ACCTCAACGTCCTCTAAAG: CCTCAACGTCCTCTAAAGA
CGTGAGAGCCCGTCAACTT: GTGAGAGCCCGTCAACTTT
CGGGCGGGATAGAGTCAGC: GGGCGGGATAGAGTCAGCT
ACTCCGGAGCCATCCATCG: CTCCGGAGCCATCCATCGA
GCATATGCCCGGGCGTGAG: CATATGCCCGGGCGTGAGA
CTGTCCCCATTAAGCACCT: TGTCCCCATTAAGCACCTA
CGGGGGACGCGAAGGGTGA: GGGGGACGCGAAGGGTGAA
ACAGGTATCGGGATCCGCC: CAGGTATCGGGATCCGCCA
ATTCAAGCAACTACTGTCC: TTCAAGCAACTACTGTCCA
GTTGCAAACTATCCTTAAT: TTGCAAACTATCCTTAATA
ATTACCGGGGCTAACGTCC: TTACCGGGGCTAACGTCCC
CACTGGTATATTTGGTGAG: ACTGGTATATTTGGTGAGT
GAGTCAGCTGGTAGCGCTA: AGTCAGCTGGTAGCGCTAG
AGCTCGTATATAGACCGGT: GCTCGTATATAGACCGGTC
CGCATTTAGATAGCTCCCA: GCATTTAGATAGCTCCCAC
CTAACGTCCCCTAGCAACG: TAACGTCCCCTAGCAACGA
AGTGCGTTGTTAATCCTGT: GTGCGTTGTTAATCCTGTT
TCCCTAAAAAGCACGGCAT: CCCTAAAAAGCACGGCATA
AGCAGCACACTTGGAACAC: GCAGCACACTTGGAACACA
GCCATTCTTAGGTCCAGTC: CCATTCTTAGGTCCAGTCC
TTCCCCAAAATCGCAATCG: TCCCCAAAATCGCAATCGG
GGATGATGTCTACTACCGC: GATGATGTCTACTACCGCC
ATCAGCTACTAATTACCGG: TCAGCTACTAATTACCGGG
AATACACTTATAAAGTGAG: ATACACTTATAAAGTGAGT
AGTGAGACAACGCATGGAC: GTGAGACAACGCATGGACT
GTCCGGTTCTGTGGAACTA: TCCGGTTCTGTGGAACTAA
GAAAACTTTACCACCGGTC: AAAACTTTACCACCGGTCT
GGGCGTGAGAGCCCGTCAA: GGCGTGAGAGCCCGTCAAC
CTCACCTCAACGTCCTCTA: TCACCTCAACGTCCTCTAA
TTGCAACTTGTCGTTACCT: TGCAACTTGTCGTTACCTT
GTACCCAAGTTTGAAAAGT: TACCCAAGTTTGAAAAGTG
AAACTATCCTTAATACTTG: AACTATCCTTAATACTTGC
ACTGTTTTCGCTCCGTCCG: CTGTTTTCGCTCCGTCCGG
ATTCTTAGGTCCAGTCCAG: TTCTTAGGTCCAGTCCAGT
GTTCTTACGGACCATTACC: TTCTTACGGACCATTACCA
TTTTCCTGTGGGTACACGG: TTTCCTGTGGGTACACGGG
CAAAGCACGGCATAATCTT: AAAGCACGGCATAATCTTT
GTTAATCCTGTTGTAAGGC: TTAATCCTGTTGTAAGGCG
GGGCTTCGACTGTTTTCGC: GGCTTCGACTGTTTTCGCT
GCGTACAAACTCAACCTGC: CGTACAAACTCAACCTGCG
CGCATGGACTGATCTGTAT: GCATGGACTGATCTGTATA
GGCGTTGGAGTGAGACAAC: GCGTTGGAGTGAGACAACG
CGAATTTAGCAAGCGAATT: GAATTTAGCAAGCGAATTT
CACGGCATAATCTTTGACG: ACGGCATAATCTTTGACGG
CGACTGTTTTCGCTCCGTC: GACTGTTTTCGCTCCGTCC
TACCACCGGTCTCTGAGGG: ACCACCGGTCTCTGAGGGA
TGTTTTCGCTCCGTCCGGG: GTTTTCGCTCCGTCCGGGA
CTTTGAATGAGAGTGCTGG: TTTGAATGAGAGTGCTGGC
TGATAGAGGGCCCGGCCTG: GATAGAGGGCCCGGCCTGG
AGCAACGAATTTAGCAAGC: GCAACGAATTTAGCAAGCG
AACACTGGTATATTTGGTG: ACACTGGTATATTTGGTGA
CAAATTAAAACACTGGTAT: AAATTAAAACACTGGTATA
TGAATGAGAGTGCTGGCGA: GAATGAGAGTGCTGGCGAT
TGCTATCGAAACACATTGT: GCTATCGAAACACATTGTG
CGTATATAGACCGGTCTTT: GTATATAGACCGGTCTTTT
AGCATGCGGGGGACGCGAA: GCATGCGGGGGACGCGAAG
TCCGCCATTCTTAGGTCCA: CCGCCATTCTTAGGTCCAG
AAGCGAATTTTCCCTTGAT: AGCGAATTTTCCCTTGATC
TCCCCTTTATTAAAGCGCT: CCCCTTTATTAAAGCGCTA
AGAGTGCTGGCGATTCCCA: GAGTGCTGGCGATTCCCAA
CCCCATTAAGCACCTAGTT: CCCATTAAGCACCTAGTTG
CCGGGACAAGAGAAGCGGA: CGGGACAAGAGAAGCGGAG
CTCGATTATAGATCCGAGC: TCGATTATAGATCCGAGCC
ACCATAGGCCCCTCGCATT: CCATAGGCCCCTCGCATTT
CGTTTAAAAGTATGATATA: GTTTAAAAGTATGATATAG
AACCCACCTCAGTTCCCCA: ACCCACCTCAGTTCCCCAA
GGAAGGCTTTCGCATCTCC: GAAGGCTTTCGCATCTCCT
ACTTGCCAGTCACCGTAGG: CTTGCCAGTCACCGTAGGC
TAGCTCCCACCTCCCATAT: AGCTCCCACCTCCCATATC
CTGCCGGGCCTCTAAGCAA: TGCCGGGCCTCTAAGCAAA
TGTAGGTTTTAATGTCGAC: GTAGGTTTTAATGTCGACC
AAGTCGCGACGGAGACGGA: AGTCGCGACGGAGACGGAG
CTCATTAAACATGGTCCGG: TCATTAAACATGGTCCGGA
ACGTGTCAGGCATCCGGTA: CGTGTCAGGCATCCGGTAG
ATAGAGGGCCCGGCCTGGC: TAGAGGGCCCGGCCTGGCT
GGGCTGTCGCCCTTGCAAC: GGCTGTCGCCCTTGCAACT
CGTTGTTAATCCTGTTGTA: GTTGTTAATCCTGTTGTAA
TCGTCGCTGGACGTGTCAG: CGTCGCTGGACGTGTCAGG
TCGAAAACTTTACCACCGG: CGAAAACTTTACCACCGGT
CACTTATAAAGTGAGTGCG: ACTTATAAAGTGAGTGCGT
GTCTGTTCCCTCGATTATA: TCTGTTCCCTCGATTATAG
GAGCGATGTGATAACTATC: AGCGATGTGATAACTATCC
TGATTTTCCGTATTCAAGC: GATTTTCCGTATTCAAGCT
TCTTTGAAGTACAGTGACA: CTTTGAAGTACAGTGACAC
CATTCAGCTTTGAGGTGAT: ATTCAGCTTTGAGGTGATT
AATGTAGGTTTTAATGTCG: ATGTAGGTTTTAATGTCGA
CATCCGGTAGGCAGTCCCT: ATCCGGTAGGCAGTCCCTT
GGTTATCACGTAAATACAC: GTTATCACGTAAATACACT
TACTTTGACCATCAGCTAC: ACTTTGACCATCAGCTACT
ACTGTCCCCATTAAGCACC: CTGTCCCCATTAAGCACCT
CCTTAATACTTGCCAGTCA: CTTAATACTTGCCAGTCAC
TGTCAATACGATAGGCATA: GTCAATACGATAGGCATAT
GTGACACGGTGATCCAAAC: TGACACGGTGATCCAAACC
CCATCAGCTACTAATTACC: CATCAGCTACTAATTACCG
GTGCGTTGTTAATCCTGTT: TGCGTTGTTAATCCTGTTG
GGGATAGAGTCAGCTGGTA: GGATAGAGTCAGCTGGTAG
ATTCTTGTTTCCTGCTATG: TTCTTGTTTCCTGCTATGG
GCTCCCACCTCCCATATCC: CTCCCACCTCCCATATCCT
ATCGAGTCAGCCATTCAGC: TCGAGTCAGCCATTCAGCT
TCAACGTCCTCTAAAGAGC: CAACGTCCTCTAAAGAGCA
CCAACCTGCCGGGCCTCTA: CAACCTGCCGGGCCTCTAA
GAAGGCTTTCGCATCTCCT: AAGGCTTTCGCATCTCCTC
GGTTTTAATGTCGACCCCC: GTTTTAATGTCGACCCCCT
TCCGGGCGGGATAGAGTCA: CCGGGCGGGATAGAGTCAG
ACGGGGACAGGCACGTGGG: CGGGGACAGGCACGTGGGG
CAGTCCCTTGCGGGCGGTT: AGTCCCTTGCGGGCGGTTA
TCGACCCCCTTAATTTCTT: CGACCCCCTTAATTTCTTT
AAGGTTCCGGGCGGGATAG: AGGTTCCGGGCGGGATAGA
AAGTTAATCGCCGGACGCG: AGTTAATCGCCGGACGCGA
TTAATCACAGATTTTCCGT: TAATCACAGATTTTCCGTA
CTTGTCGTTACCTTGTCGG: TTGTCGTTACCTTGTCGGA
TTAGGTCCAGTCCAGTAAT: TAGGTCCAGTCCAGTAATA
CGGGATCCGCCATTCTTAG: GGGATCCGCCATTCTTAGG
TACGGACCATTACCATAGG: ACGGACCATTACCATAGGC
CCCCTTTATTAAAGCGCTA: CCCTTTATTAAAGCGCTAC
CTTTACCACCGGTCTCTGA: TTTACCACCGGTCTCTGAG
CGAATCCCTAAAAAGCACG: GAATCCCTAAAAAGCACGG
TTTCCGTATTCAAGCAACT: TTCCGTATTCAAGCAACTA
CTTTTCCTGTGGGTACACG: TTTTCCTGTGGGTACACGG
TTAATCGCCGGACGCGAGC: TAATCGCCGGACGCGAGCT
CTTCATACCAGGCCGTTCT: TTCATACCAGGCCGTTCTT
TTGCCAGTCACCGTAGGCA: TGCCAGTCACCGTAGGCAA
ATGTGATAACTATCCCTAT: TGTGATAACTATCCCTATT
GGATGTCGACAAAAGCACG: GATGTCGACAAAAGCACGG
GCCTTTACAGGGTTTTGTT: CCTTTACAGGGTTTTGTTC
GATCTGCTATCGAAACACA: ATCTGCTATCGAAACACAT
AAGCGGATGTCGACAAAAG: AGCGGATGTCGACAAAAGC
TGATATAGAGTTCAAAGTC: GATATAGAGTTCAAAGTCG
AAGGCGTACCCAAGTTTGA: AGGCGTACCCAAGTTTGAA
TCCGGATCGTCGCTGGACG: CCGGATCGTCGCTGGACGT
ATTATAGATCCGAGCCTTT: TTATAGATCCGAGCCTTTA
ACGGCATAATCTTTTACGC: CGGCATAATCTTTTACGCA
TGTTGTAACGCGAACCTTG: GTTGTAACGCGAACCTTGA
ACCTAGAGCTCGTATATAG: CCTAGAGCTCGTATATAGA
TATCTCAATGTGCCTACTG: ATCTCAATGTGCCTACTGC
TGTTCTCTGGCGGCACGTC: GTTCTCTGGCGGCACGTCG
ATTTCTTTGAAGTACAGTG: TTTCTTTGAAGTACAGTGA
GTTGTTGTAACGCGAACCT: TTGTTGTAACGCGAACCTT
GTCAGGCATCCGGTAGGCA: TCAGGCATCCGGTAGGCAG
ATTGGTCGAAGTATACTTT: TTGGTCGAAGTATACTTTG
TGGTCCCCACGTCACGTTT: GGTCCCCACGTCACGTTTA
TGGACTGATCTGTATAGAG: GGACTGATCTGTATAGAGC
CATGCGTGCCACTCAATGT: ATGCGTGCCACTCAATGTA
ATACTTGCCAGTCACCGTA: TACTTGCCAGTCACCGTAG
GCTCTTTGAATGAGAGTGC: CTCTTTGAATGAGAGTGCT
CCACAGGTATCGGGATCCG: CACAGGTATCGGGATCCGC
GCCATGGATTCTTGTTTCC: CCATGGATTCTTGTTTCCT
CCGGGGCTAACGTCCCCTA: CGGGGCTAACGTCCCCTAG
TGGAGTGAGACAACGCATG: GGAGTGAGACAACGCATGG
CCCGGCCTGGCTCTTTGAA: CCGGCCTGGCTCTTTGAAT
CCTGCGGATTCAGGGCAAA: CTGCGGATTCAGGGCAAAA
GTCAGCCATTCAGCTTTGA: TCAGCCATTCAGCTTTGAG
AGGCAGTCCCTTGCGGGCG: GGCAGTCCCTTGCGGGCGG
GCCAGTCACCGTAGGCAAG: CCAGTCACCGTAGGCAAGG
AACCTGCGGAGCTTACCTA: ACCTGCGGAGCTTACCTAG
GTGGACGCACGGAGTAAGT: TGGACGCACGGAGTAAGTA
ATCTGCTATCGAAACACAT: TCTGCTATCGAAACACATT
AAACTGTCCCCATTAAGCA: AACTGTCCCCATTAAGCAC
GCCTACTGCGCGATTATGG: CCTACTGCGCGATTATGGT
GGCCTCATTAAACATGGTC: GCCTCATTAAACATGGTCC
TCCCTCGATTATAGATCCG: CCCTCGATTATAGATCCGA
GGTGCTAGCACCACTTCTT: GTGCTAGCACCACTTCTTA
AGCGCTAGGTTAAATCTAG: GCGCTAGGTTAAATCTAGC
GAGCATGCGGGGGACGCGA: AGCATGCGGGGGACGCGAA
GGGTGAATGGTCTTCTACG: GGTGAATGGTCTTCTACGG
TTGGATTTTCCGTATTCAA: TGGATTTTCCGTATTCAAG
CCGGTAGGCAGTCCCTTGC: CGGTAGGCAGTCCCTTGCG
CAACTACTGTCCAAAGCAC: AACTACTGTCCAAAGCACG
TTACCTTGTCGGAGCTCAA: TACCTTGTCGGAGCTCAAG
GCAACTACTGTCCAAAGCA: CAACTACTGTCCAAAGCAC
AAGGAGAACAGTCTAGTGC: AGGAGAACAGTCTAGTGCG
TCTAAGGATTTGAGCATTA: CTAAGGATTTGAGCATTAT
CGGGCCTCATTAAACATGG: GGGCCTCATTAAACATGGT
GAGAGCCCGTCAACTTTTC: AGAGCCCGTCAACTTTTCC
TTTTACGCACTCCGGAGCC: TTTACGCACTCCGGAGCCA
CCTTTACAGGGTTTTGTTC: CTTTACAGGGTTTTGTTCT
TGATGTCTACTACCGCCAA: GATGTCTACTACCGCCAAC
GTACAGTGACACGGTGATC: TACAGTGACACGGTGATCC
AACGCGAAAGCACCTGGCC: ACGCGAAAGCACCTGGCCC
GTACACGGGGAGCACCCAA: TACACGGGGAGCACCCAAG
AAGTGGAAAAGCACGGCAT: AGTGGAAAAGCACGGCATA
TTTGAGCATTATTGGTTAT: TTGAGCATTATTGGTTATA
GTCGACCCCCTTAATTTCT: TCGACCCCCTTAATTTCTT
CCAGTCACCGTAGGCAAGG: CAGTCACCGTAGGCAAGGG
TTTATTGGATTTTCCGTAT: TTATTGGATTTTCCGTATT
GAGTCGAGCAAATTAAAAC: AGTCGAGCAAATTAAAACA
GGACAGGCACGTGGGGGGG: GACAGGCACGTGGGGGGGG
TTCGACTGTTTTCGCTCCG: TCGACTGTTTTCGCTCCGT
TAACGGGCTGTCGCCCTTG: AACGGGCTGTCGCCCTTGC
CACCGGTCTCTGAGGGACT: ACCGGTCTCTGAGGGACTC
TAAAGTGAGTGCGTTGTTA: AAAGTGAGTGCGTTGTTAA
GAGTGTCATCCGGTTGGAA: AGTGTCATCCGGTTGGAAG
TTTCCGTATTCAAGCCGAA: TTCCGTATTCAAGCCGAAT
TCAGTTCCCCAAAATCGCA: CAGTTCCCCAAAATCGCAA
ACCACCGGTCTCTGAGGGA: CCACCGGTCTCTGAGGGAC
CCAGTAATACGCAGAAGGA: CAGTAATACGCAGAAGGAG
TCGCTTAACAGTTCGTCTG: CGCTTAACAGTTCGTCTGG
GGCATCCGGTAGGCAGTCC: GCATCCGGTAGGCAGTCCC
ACTCAACCTGCGGAGCTTA: CTCAACCTGCGGAGCTTAC
CTTCTACGGGGGTCCTACT: TTCTACGGGGGTCCTACTA
GGTCCCCACGTCACGTTTA: GTCCCCACGTCACGTTTAA
TCGATTATAGATCCGAGCC: CGATTATAGATCCGAGCCT
GGGTGCTAGCACCACTTCT: GGTGCTAGCACCACTTCTT
TGTCGATTTTCCGTATTCA: GTCGATTTTCCGTATTCAA
TTGGAAGGCTTTCGCATCT: TGGAAGGCTTTCGCATCTC
TCATTTACGAAGCAATCAT: CATTTACGAAGCAATCATC
TGTCCCCATTAAGCACCTA: GTCCCCATTAAGCACCTAG
ACTCAATGTAGGTTTTAAT: CTCAATGTAGGTTTTAATG
CTTGAACGGGCCTCATTAA: TTGAACGGGCCTCATTAAA
TAGGCGTTGGAGTGAGACA: AGGCGTTGGAGTGAGACAA
CGGGATAGAGTCAGCTGGT: GGGATAGAGTCAGCTGGTA
TGCGGATTCAGGGCAAAAT: GCGGATTCAGGGCAAAATA
CCATTAAGCACCTAGTTGC: CATTAAGCACCTAGTTGCA
AATCTTTACGCACCTAGGC: ATCTTTACGCACCTAGGCG
TAATATGTCGTCCACCTCC: AATATGTCGTCCACCTCCT
CCTCAACGTCCTCTAAAGA: CTCAACGTCCTCTAAAGAG
TTTACCACCGGTCTCTGAG: TTACCACCGGTCTCTGAGG
TCTGAGAAAGAACCGAATC: CTGAGAAAGAACCGAATCC
TTATGGTCCCCACGTCACG: TATGGTCCCCACGTCACGT
GCGAAGGGTGAATGGTCTT: CGAAGGGTGAATGGTCTTC
AGGTCCAGTCCAGTAATAC: GGTCCAGTCCAGTAATACG
ATTAAAACACTGGTATATT: TTAAAACACTGGTATATTT
CAGCTCACTTACATACGCT: AGCTCACTTACATACGCTT
CAAATTGGTAATACCAGTT: AAATTGGTAATACCAGTTC
TGGTTGTTGTAACGCGAAC: GGTTGTTGTAACGCGAACC
ATCGAAACACATTGTGCTT: TCGAAACACATTGTGCTTT
ACTGATAGAGGGCCCGGCC: CTGATAGAGGGCCCGGCCT
TGAGAAAGAACCGAATCCC: GAGAAAGAACCGAATCCCC
GCAACGAATTTAGCAAGCG: CAACGAATTTAGCAAGCGA
CTCAAGCCGAGCTTCATAC: TCAAGCCGAGCTTCATACC
GGAACACAATTCTGCCCAT: GAACACAATTCTGCCCATG
GCCCACAGGTATCGGGATC: CCCACAGGTATCGGGATCC
TGGAAAAGCACGGCATAAT: GGAAAAGCACGGCATAATC
CACCTAGGCGTTGGAGTGA: ACCTAGGCGTTGGAGTGAG
ATCCAAACCGCGTACAAAC: TCCAAACCGCGTACAAACT
ATCGGATTGGTCGAAGTAT: TCGGATTGGTCGAAGTATA
CGCCGGACGCGAGCTAAGA: GCCGGACGCGAGCTAAGAT
GCGGAGCCATGGATTCTTG: CGGAGCCATGGATTCTTGT
CGGCATAATCTTTACGCAC: GGCATAATCTTTACGCACC
TACCGGGGCTAACGTCCCC: ACCGGGGCTAACGTCCCCT
CGTGTCAGGCATCCGGTAG: GTGTCAGGCATCCGGTAGG
GTCATTTACGAAGCAATCA: TCATTTACGAAGCAATCAT
CGGATTCAGGGCAAAATAA: GGATTCAGGGCAAAATAAC
CGGAGCTTACCTAGAGCTC: GGAGCTTACCTAGAGCTCG
GAAGCGGAGCCATGGATTC: AAGCGGAGCCATGGATTCT
GAGTGCTGGCGATTCCCAA: AGTGCTGGCGATTCCCAAC
GGTAGGCAGTCCCTTGCGG: GTAGGCAGTCCCTTGCGGG
TGGCGGGCTTCGACTGTTT: GGCGGGCTTCGACTGTTTT
GGTCGAAGTATACTTTGAC: GTCGAAGTATACTTTGACC
GAGACAACGCATGGACTGA: AGACAACGCATGGACTGAT
AACGCGAACCTTGAACGGG: ACGCGAACCTTGAACGGGC
AGCTCAAGGTTCCGGGCGG: GCTCAAGGTTCCGGGCGGG
ACACTTGGAACACAATTCT: CACTTGGAACACAATTCTG
GACAAAAGCACGGCATAAT: ACAAAAGCACGGCATAATC
AGGTTCCGGGCGGGATAGA: GGTTCCGGGCGGGATAGAG
TAGACCGGTCTTTTTGTGT: AGACCGGTCTTTTTGTGTG
TAGGCAGTCCCTTGCGGGC: AGGCAGTCCCTTGCGGGCG
AGCACGGCATAATCTTTAC: GCACGGCATAATCTTTACG
ATCACCTGTTAGGTGGAGT: TCACCTGTTAGGTGGAGTC
GATTCAGGGCAAAATAACG: ATTCAGGGCAAAATAACGG
GGATAGAGTCAGCTGGTAG: GATAGAGTCAGCTGGTAGC
CTCTAAGCAAATTGGTAAT: TCTAAGCAAATTGGTAATA
TGCATGACTGATAGAGGGC: GCATGACTGATAGAGGGCC
GAACCGAATCCCCTTTATT: AACCGAATCCCCTTTATTA
AACAACTGTCTCATACGGG: ACAACTGTCTCATACGGGG
ACGCACGGAGTAAGTAGTG: CGCACGGAGTAAGTAGTGG
ACTGGTTGTTGTAACGCGA: CTGGTTGTTGTAACGCGAA
CGGATCGTCGCTGGACGTG: GGATCGTCGCTGGACGTGT
ACGTTTAAAAGTATGATAT: CGTTTAAAAGTATGATATA
GGCTGTCGCCCTTGCAACT: GCTGTCGCCCTTGCAACTT
GGAGCCATGGATTCTTGTT: GAGCCATGGATTCTTGTTT
TAAGGCGGTTATGAGATCA: AAGGCGGTTATGAGATCAC
GTTCAAGGGTGGACGCACG: TTCAAGGGTGGACGCACGG
TCCTGTGGGTACACGGGGA: CCTGTGGGTACACGGGGAG
TGATCATGCGTGCCACTCA: GATCATGCGTGCCACTCAA
CATGGTCCGGATCGTCGCT: ATGGTCCGGATCGTCGCTG
ATCATGCGTGCCACTCAAT: TCATGCGTGCCACTCAATG
CCTATTTAAGGCGGTTATG: CTATTTAAGGCGGTTATGA
GGTCTCTGAGGGACTCGCT: GTCTCTGAGGGACTCGCTT
GACAGCTTTATATGCCTGC: ACAGCTTTATATGCCTGCG
GTAGGTTTTAATGTCGACC: TAGGTTTTAATGTCGACCC
GAGATCACAAACTGTCCCC: AGATCACAAACTGTCCCCA
GATTTGATCTGCTATCGAA: ATTTGATCTGCTATCGAAA
GAGTTCAAAGTCGCGACGG: AGTTCAAAGTCGCGACGGA
CCTCACCTCAACGTCCTCT: CTCACCTCAACGTCCTCTA
TAATCCTGTTGTAAGGCGT: AATCCTGTTGTAAGGCGTA
CGGGCGTGAGAGCCCGTCA: GGGCGTGAGAGCCCGTCAA
GTCCAGTAATACGCAGAAG: TCCAGTAATACGCAGAAGG
CTGGACGTGTCAGGCATCC: TGGACGTGTCAGGCATCCG
TGAGATCACAAACTGTCCC: GAGATCACAAACTGTCCCC
TGAATGGTCTTCTACGGGG: GAATGGTCTTCTACGGGGG
CGCGAACCTTGAACGGGCC: GCGAACCTTGAACGGGCCT
ATCTAGCAGCACACTTGGA: TCTAGCAGCACACTTGGAA
ATGGAGGATGATGTCTACT: TGGAGGATGATGTCTACTA
GCAAGCGAATTTTCCCTTG: CAAGCGAATTTTCCCTTGA
CCACCTCCTACTGGTTGTT: CACCTCCTACTGGTTGTTG
TTTACGCACTCCGGAGCCA: TTACGCACTCCGGAGCCAT
GTCACGTTTAAAAGTATGA: TCACGTTTAAAAGTATGAT
TCATACGGGGTCATTTACG: CATACGGGGTCATTTACGA
CAGTCCAGTAATACGCAGA: AGTCCAGTAATACGCAGAA
AGCCTTTACAGGGTTTTGT: GCCTTTACAGGGTTTTGTT
CCATCGAGACAGCTTTATA: CATCGAGACAGCTTTATAT
GTTATGAGATCACAAACTG: TTATGAGATCACAAACTGT
TTGAATGAGAGTGCTGGCG: TGAATGAGAGTGCTGGCGA
GAGCCTTTACAGGGTTTTG: AGCCTTTACAGGGTTTTGT
GCTTTCGCATCTCCTCACC: CTTTCGCATCTCCTCACCT
TGTCGCCCTTGCAACTTGT: GTCGCCCTTGCAACTTGTC
